//MAP CONVERTED BY dmm2tgm.py THIS HEADER COMMENT PREVENTS RECONVERSION, DO NOT REMOVE
"ab" = (
/obj/structure/cult/anomaly/spacewhole,
/obj/structure/cult/anomaly/shell,
/turf/simulated/floor/engine/cult,
/area/mafia)
"ac" = (
/obj/structure/cult/anomaly/timewhole,
/turf/simulated/floor/engine/cult,
/area/mafia)
"ad" = (
/obj/structure/cult/anomaly/spacewhole,
/obj/structure/cult/anomaly/timewhole,
/obj/structure/cult/anomaly/shell,
/turf/simulated/floor/engine/cult,
/area/mafia)
"ae" = (
/obj/structure/cult/anomaly/shell,
/turf/simulated/floor/engine/cult/lava,
/area/mafia)
"af" = (
/obj/structure/cult/anomaly/spacewhole,
/obj/structure/cult/anomaly/shell,
/turf/simulated/floor/engine/cult/lava,
/area/mafia)
"ag" = (
/obj/structure/cult/anomaly/spacewhole,
/turf/simulated/floor/engine/cult/lava,
/area/mafia)
"ah" = (
/obj/structure/cult/anomaly/timewhole,
/turf/simulated/floor/engine/cult/lava,
/area/mafia)
"ai" = (
/obj/structure/cult/anomaly/timewhole,
/obj/structure/cult/anomaly/shell,
/turf/simulated/floor/engine/cult/lava,
/area/mafia)
"aj" = (
/obj/structure/cult/anomaly/timewhole,
/obj/structure/cult/anomaly/shell,
/turf/simulated/floor/engine/cult,
/area/mafia)
"ak" = (
/obj/structure/cult/anomaly/shell,
/obj/structure/cult/anomaly/shell,
/turf/simulated/floor/engine/cult,
/area/mafia)
"al" = (
/obj/structure/cult/anomaly/spacewhole,
/obj/structure/cult/anomaly/timewhole,
/turf/simulated/floor/engine/cult/lava,
/area/mafia)
"am" = (
/obj/structure/cult/anomaly/spacewhole,
/obj/structure/cult/anomaly/timewhole,
/turf/simulated/floor/engine/cult,
/area/mafia)
"an" = (
/obj/structure/cult/anomaly/spacewhole,
/obj/structure/cult/anomaly/timewhole,
/obj/structure/cult/anomaly/shell,
/obj/structure/cult/anomaly/shell,
/turf/simulated/floor/engine/cult,
/area/mafia)
"ao" = (
/obj/structure/cult/anomaly/spacewhole,
/turf/unsimulated/wall/cult/runed,
/area/mafia)
"ap" = (
/obj/structure/cult/anomaly/spacewhole,
/obj/structure/cult/anomaly/timewhole,
/obj/structure/cult/anomaly/timewhole,
/turf/simulated/floor/engine/cult,
/area/mafia)
"ei" = (
/obj/effect/landmark/mafia,
/turf/simulated/floor/engine/cult,
/area/mafia)
"gN" = (
/obj/mafia_game_board,
/turf/simulated/floor/engine/cult,
/area/mafia)
"hS" = (
/turf/simulated/wall/cult/runed/anim,
/area/mafia)
"ks" = (
/obj/effect/forcefield/cult,
/turf/simulated/floor/engine/cult,
/area/mafia)
"rp" = (
/obj/structure/cult/anomaly/spacewhole,
/turf/simulated/floor/engine/cult,
/area/mafia)
"xg" = (
/turf/unsimulated/wall/cult/runed,
/area/mafia)
"xM" = (
/obj/structure/cult/pylon,
/turf/simulated/floor/engine/cult/lava,
/area/mafia)
"yl" = (
/turf/simulated/floor/engine/cult,
/area/mafia)
"CT" = (
/obj/structure/cult/anomaly/shell,
/turf/unsimulated/wall/cult/runed,
/area/mafia)
"ER" = (
/obj/machinery/optable/torture_table,
/turf/simulated/floor/engine/cult,
/area/mafia)
"Fc" = (
/obj/structure/cult/anomaly/shell,
/turf/simulated/floor/engine/cult,
/area/mafia)
"HU" = (
/turf/unsimulated/wall,
/area/mafia)
"TH" = (
/obj/effect/landmark/mafia/town_center,
/turf/simulated/floor/engine/cult,
/area/mafia)
"TX" = (
/obj/machinery/door/poddoor/mafia,
/obj/structure/window/fulltile/reinforced/indestructible,
/turf/unsimulated/floor,
/area/mafia)
"Zo" = (
/turf/simulated/floor/engine/cult/lava,
/area/mafia)

(1,1,1) = {"
HU
HU
HU
HU
HU
HU
HU
HU
HU
HU
HU
HU
HU
HU
HU
HU
HU
HU
HU
HU
HU
HU
HU
"}
(2,1,1) = {"
HU
xg
xg
xg
xg
xg
xg
xg
xg
xg
xg
xg
xg
xg
xg
xg
xg
xg
xg
xg
xg
xg
HU
"}
(3,1,1) = {"
HU
xg
xg
yl
Fc
ac
yl
aj
Fc
ak
aj
aj
ac
Fc
ac
ac
am
yl
ab
yl
xg
xg
HU
"}
(4,1,1) = {"
HU
xg
xg
yl
gN
yl
ae
Zo
ah
Zo
Zo
Zo
ae
Zo
Zo
ah
ah
Fc
gN
yl
xg
xg
HU
"}
(5,1,1) = {"
HU
xg
xg
yl
Fc
Zo
ae
xM
xg
xg
ks
xg
ks
xg
ao
xM
Zo
Zo
ad
yl
xg
xg
HU
"}
(6,1,1) = {"
HU
xg
xg
Fc
Zo
xg
xg
ks
xg
ER
yl
xg
yl
ER
xg
ks
xg
xg
Zo
Fc
xg
xg
HU
"}
(7,1,1) = {"
HU
xg
xg
yl
Zo
xg
ER
yl
TX
ei
yl
TX
yl
ei
TX
yl
ER
xg
Zo
am
yl
xg
HU
"}
(8,1,1) = {"
HU
xg
yl
ae
xM
xg
ei
yl
hS
hS
yl
hS
yl
hS
hS
yl
ei
xg
xM
Zo
yl
xg
HU
"}
(9,1,1) = {"
HU
xg
Fc
af
xg
xg
TX
yl
yl
TX
yl
TX
yl
TX
yl
yl
TX
xg
xg
ah
ap
xg
HU
"}
(10,1,1) = {"
HU
xg
Fc
ag
xg
ER
TX
hS
TX
TX
TX
TX
TX
TX
TX
hS
TX
ER
xg
Zo
ac
xg
HU
"}
(11,1,1) = {"
HU
xg
rp
ae
ks
ei
yl
yl
yl
TX
Zo
yl
Zo
TX
yl
yl
yl
ei
ks
Zo
yl
xg
HU
"}
(12,1,1) = {"
HU
xg
ab
Zo
xg
xg
TX
hS
TX
TX
yl
TH
yl
TX
TX
hS
TX
xg
xg
ag
ac
xg
HU
"}
(13,1,1) = {"
HU
CT
rp
Zo
ks
ei
yl
yl
yl
TX
Zo
yl
Zo
TX
yl
yl
yl
ei
ks
Zo
ac
xg
HU
"}
(14,1,1) = {"
HU
xg
ac
Zo
xg
ER
TX
hS
TX
TX
TX
TX
TX
TX
TX
hS
TX
ER
xg
ah
am
xg
HU
"}
(15,1,1) = {"
HU
xg
ad
Zo
xg
xg
TX
yl
yl
TX
yl
TX
yl
TX
yl
yl
TX
xg
xg
Zo
ac
xg
HU
"}
(16,1,1) = {"
HU
xg
rp
af
xM
xg
ei
yl
hS
hS
yl
hS
yl
hS
hS
yl
ei
xg
xM
al
ac
xg
HU
"}
(17,1,1) = {"
HU
xg
yl
Zo
ah
xg
ER
yl
TX
ei
yl
TX
yl
ei
TX
yl
ER
xg
Zo
am
yl
xg
HU
"}
(18,1,1) = {"
HU
xg
xg
rp
ah
xg
xg
ks
xg
ER
yl
xg
yl
ER
xg
ks
xg
xg
Zo
ac
xg
xg
HU
"}
(19,1,1) = {"
HU
xg
xg
yl
ac
Zo
Zo
xM
xg
xg
ks
xg
ks
xg
xg
xM
Zo
Zo
yl
yl
xg
xg
HU
"}
(20,1,1) = {"
HU
xg
xg
yl
gN
ab
ai
ah
ah
al
af
ae
Zo
ag
af
ae
Zo
yl
gN
rp
xg
xg
HU
"}
(21,1,1) = {"
HU
xg
xg
yl
yl
yl
rp
rp
ab
yl
am
ac
an
ac
aj
am
rp
rp
yl
yl
xg
xg
HU
"}
(22,1,1) = {"
HU
xg
xg
xg
xg
xg
xg
xg
xg
xg
xg
xg
xg
xg
xg
xg
xg
xg
xg
xg
xg
xg
HU
"}
(23,1,1) = {"
HU
HU
HU
HU
HU
HU
HU
HU
HU
HU
HU
HU
HU
HU
HU
HU
HU
HU
HU
HU
HU
HU
HU
"}
