//MAP CONVERTED BY dmm2tgm.py THIS HEADER COMMENT PREVENTS RECONVERSION, DO NOT REMOVE
"a" = (
/turf/unsimulated/wall,
/area/mafia)
"b" = (
/obj/structure/closet/syndicate{
	desc = "A storage closet for syndicate conflict resolution operatives.";
	name = "red closet"
	},
/obj/item/clothing/under/syndicate/tacticool,
/turf/unsimulated/floor{
	icon_state = "floor"
	},
/area/mafia)
"c" = (
/turf/simulated/floor/plating/ironsand,
/area/mafia)
"d" = (
/obj/item/clothing/under/syndicate/tacticool,
/obj/structure/closet/syndicate{
	desc = "A storage closet for syndicate conflict resolution operatives.";
	name = "red closet"
	},
/turf/unsimulated/floor{
	icon_state = "bar"
	},
/area/mafia)
"g" = (
/obj/mafia_game_board,
/turf/simulated/floor/plating{
	icon_state = "platingdmg3"
	},
/area/mafia)
"j" = (
/obj/machinery/door/airlock/maintenance_hatch{
	locked = 1;
	req_access = list(101)
	},
/turf/simulated/floor/plating,
/area/mafia)
"k" = (
/obj/mafia_game_board,
/turf/simulated/floor/plating,
/area/mafia)
"l" = (
/obj/structure/closet/syndicate{
	desc = "A storage closet for syndicate conflict resolution operatives.";
	name = "red closet"
	},
/obj/item/clothing/under/syndicate/tacticool,
/turf/unsimulated/floor{
	icon_state = "bar"
	},
/area/mafia)
"n" = (
/obj/effect/landmark/mafia,
/turf/unsimulated/floor{
	icon_state = "floor"
	},
/area/mafia)
"o" = (
/turf/unsimulated/floor{
	icon_state = "bar"
	},
/area/mafia)
"p" = (
/obj/machinery/door/poddoor/mafia,
/turf/unsimulated/wall/fakeglass,
/area/mafia)
"r" = (
/turf/unsimulated/floor{
	icon_state = "floor"
	},
/area/mafia)
"s" = (
/turf/unsimulated/floor{
	dir = 9;
	icon_state = "podhatch"
	},
/area/mafia)
"t" = (
/turf/unsimulated/floor{
	dir = 1;
	icon_state = "podhatch"
	},
/area/mafia)
"u" = (
/obj/effect/landmark/mafia/town_center,
/turf/unsimulated/floor{
	icon_state = "podhatchfull"
	},
/area/mafia)
"v" = (
/obj/mafia_game_board,
/turf/simulated/floor/plating{
	icon_state = "panelscorched"
	},
/area/mafia)
"w" = (
/turf/simulated/mineral,
/area/mafia)
"A" = (
/turf/unsimulated/floor{
	dir = 5;
	icon_state = "podhatch"
	},
/area/mafia)
"B" = (
/turf/unsimulated/floor{
	dir = 8;
	icon_state = "podhatch"
	},
/area/mafia)
"C" = (
/turf/unsimulated/floor{
	dir = 4;
	icon_state = "podhatch"
	},
/area/mafia)
"E" = (
/turf/unsimulated/floor{
	dir = 10;
	icon_state = "podhatch"
	},
/area/mafia)
"F" = (
/turf/unsimulated/floor{
	icon_state = "podhatch"
	},
/area/mafia)
"G" = (
/turf/unsimulated/floor{
	dir = 6;
	icon_state = "podhatch"
	},
/area/mafia)
"H" = (
/obj/effect/landmark/mafia,
/turf/unsimulated/floor{
	icon_state = "bar"
	},
/area/mafia)

(1,1,1) = {"
a
a
a
a
a
a
a
a
a
a
a
a
a
a
a
a
a
a
a
a
a
a
a
"}
(2,1,1) = {"
a
w
w
w
w
w
w
w
w
w
w
w
w
w
w
w
w
w
w
w
w
w
a
"}
(3,1,1) = {"
a
w
w
w
c
w
w
w
w
w
w
w
w
w
w
w
w
w
c
w
w
w
a
"}
(4,1,1) = {"
a
w
w
c
g
c
w
w
w
w
w
w
w
w
w
w
w
c
k
c
w
w
a
"}
(5,1,1) = {"
a
w
w
w
c
w
w
w
a
a
j
a
j
a
a
w
w
w
c
w
w
w
a
"}
(6,1,1) = {"
a
w
w
w
w
a
a
j
a
b
r
a
o
l
a
j
a
a
w
w
w
w
a
"}
(7,1,1) = {"
a
w
w
w
w
a
l
o
p
n
r
p
o
H
p
r
b
a
w
w
w
w
a
"}
(8,1,1) = {"
a
w
w
w
w
a
H
o
a
a
r
a
o
a
a
r
n
a
w
w
w
w
a
"}
(9,1,1) = {"
a
w
w
w
a
a
p
o
o
p
r
p
o
p
r
r
p
a
a
w
w
w
a
"}
(10,1,1) = {"
a
w
w
w
a
b
p
a
p
p
p
p
p
p
p
a
p
l
a
w
w
w
a
"}
(11,1,1) = {"
a
w
w
w
j
n
r
r
r
p
s
B
E
p
o
o
o
H
j
w
w
w
a
"}
(12,1,1) = {"
a
w
w
w
a
a
p
a
p
p
t
u
F
p
p
a
p
a
a
w
w
w
a
"}
(13,1,1) = {"
a
w
w
w
j
H
o
o
o
p
A
C
G
p
r
r
r
n
j
w
w
w
a
"}
(14,1,1) = {"
a
w
w
w
a
l
p
a
p
p
p
p
p
p
p
a
p
b
a
w
w
w
a
"}
(15,1,1) = {"
a
w
w
w
a
a
p
r
r
p
o
p
r
p
o
o
p
a
a
w
w
w
a
"}
(16,1,1) = {"
a
w
w
w
w
a
n
r
a
a
o
a
r
a
a
o
H
a
w
w
w
w
a
"}
(17,1,1) = {"
a
w
w
w
w
a
b
r
p
H
o
p
r
n
p
o
d
a
w
w
w
w
a
"}
(18,1,1) = {"
a
w
w
w
w
a
a
j
a
l
o
a
r
b
a
j
a
a
w
w
w
w
a
"}
(19,1,1) = {"
a
w
w
w
c
w
w
w
a
a
j
a
j
a
a
w
w
w
c
w
w
w
a
"}
(20,1,1) = {"
a
w
w
c
k
c
w
w
w
w
w
w
w
w
w
w
w
c
v
c
w
w
a
"}
(21,1,1) = {"
a
w
w
w
c
w
w
w
w
w
w
w
w
w
w
w
w
w
c
w
w
w
a
"}
(22,1,1) = {"
a
w
w
w
w
w
w
w
w
w
w
w
w
w
w
w
w
w
w
w
w
w
a
"}
(23,1,1) = {"
a
a
a
a
a
a
a
a
a
a
a
a
a
a
a
a
a
a
a
a
a
a
a
"}
