//MAP CONVERTED BY dmm2tgm.py THIS HEADER COMMENT PREVENTS RECONVERSION, DO NOT REMOVE
"ei" = (
/obj/effect/landmark/mafia,
/obj/machinery/optable/torture_table,
/turf/simulated/floor/engine/cult,
/area/mafia)
"gN" = (
/obj/mafia_game_board,
/turf/simulated/floor/engine/cult,
/area/mafia)
"hS" = (
/turf/simulated/wall/cult/runed/anim,
/area/mafia)
"ks" = (
/obj/effect/forcefield/cult,
/turf/simulated/floor/engine/cult,
/area/mafia)
"rp" = (
/obj/structure/cult/pylon,
/turf/simulated/floor/engine/cult,
/area/mafia)
"xg" = (
/turf/unsimulated/wall/cult/runed,
/area/mafia)
"xM" = (
/obj/structure/cult/pylon,
/turf/simulated/floor/engine/cult/lava,
/area/mafia)
"yl" = (
/turf/simulated/floor/engine/cult,
/area/mafia)
"CT" = (
/obj/structure/cult/statue,
/turf/simulated/floor/engine/cult,
/area/mafia)
"ER" = (
/obj/structure/closet/coffin,
/turf/simulated/floor/engine/cult,
/area/mafia)
"Fc" = (
/obj/effect/anomaly/bluespace/cult_portal,
/turf/simulated/floor/engine/cult,
/area/mafia)
"HU" = (
/turf/unsimulated/wall,
/area/mafia)
"TH" = (
/obj/effect/landmark/mafia/town_center,
/turf/simulated/floor/engine/cult,
/area/mafia)
"TX" = (
/obj/machinery/door/poddoor/mafia{
	desc = "When it's time to sleep, the lights will go out. Remember - no one in space can hear you scream.";
	id = "mafia";
	max_integrity = 99999;
	name = "Station Night Shutters"
	},
/turf/unsimulated/wall/fakeglass,
/area/mafia)
"Zo" = (
/turf/simulated/floor/engine/cult/lava,
/area/mafia)

(1,1,1) = {"
HU
HU
HU
HU
HU
HU
HU
HU
HU
HU
HU
HU
HU
HU
HU
HU
HU
HU
HU
HU
HU
HU
HU
"}
(2,1,1) = {"
HU
xg
xg
xg
xg
xg
xg
xg
xg
xg
xg
xg
xg
xg
xg
xg
xg
xg
xg
xg
xg
xg
HU
"}
(3,1,1) = {"
HU
xg
xg
rp
yl
yl
yl
yl
yl
yl
yl
yl
yl
yl
yl
yl
yl
yl
yl
rp
xg
xg
HU
"}
(4,1,1) = {"
HU
xg
xg
yl
gN
CT
Zo
Zo
Zo
Zo
Zo
Zo
Zo
Zo
Zo
Zo
Zo
CT
gN
yl
xg
xg
HU
"}
(5,1,1) = {"
HU
xg
xg
yl
CT
Zo
Zo
xM
xg
xg
ks
xg
ks
xg
xg
xM
Zo
Zo
CT
yl
xg
xg
HU
"}
(6,1,1) = {"
HU
xg
xg
yl
Zo
xg
xg
ks
xg
ER
yl
xg
yl
ER
xg
ks
xg
xg
Zo
yl
xg
xg
HU
"}
(7,1,1) = {"
HU
xg
xg
yl
Zo
xg
ER
yl
TX
ei
yl
TX
yl
ei
TX
yl
ER
xg
Zo
yl
Fc
xg
HU
"}
(8,1,1) = {"
HU
xg
Fc
Zo
xM
xg
ei
yl
hS
hS
yl
hS
yl
hS
hS
yl
ei
xg
xM
Zo
yl
xg
HU
"}
(9,1,1) = {"
HU
xg
yl
Zo
xg
xg
TX
yl
yl
TX
yl
TX
yl
TX
yl
yl
TX
xg
xg
Zo
yl
xg
HU
"}
(10,1,1) = {"
HU
xg
yl
Zo
xg
ER
TX
hS
TX
TX
TX
TX
TX
TX
TX
hS
TX
ER
xg
Zo
yl
xg
HU
"}
(11,1,1) = {"
HU
xg
yl
Zo
ks
ei
yl
yl
yl
TX
Zo
yl
Zo
TX
yl
yl
yl
ei
ks
Zo
yl
xg
HU
"}
(12,1,1) = {"
HU
xg
Fc
Zo
xg
xg
TX
hS
TX
TX
yl
TH
yl
TX
TX
hS
TX
xg
xg
Zo
Fc
xg
HU
"}
(13,1,1) = {"
HU
xg
yl
Zo
ks
ei
yl
yl
yl
TX
Zo
yl
Zo
TX
yl
yl
yl
ei
ks
Zo
yl
xg
HU
"}
(14,1,1) = {"
HU
xg
yl
Zo
xg
ER
TX
hS
TX
TX
TX
TX
TX
TX
TX
hS
TX
ER
xg
Zo
yl
xg
HU
"}
(15,1,1) = {"
HU
xg
yl
Zo
xg
xg
TX
yl
yl
TX
yl
TX
yl
TX
yl
yl
TX
xg
xg
Zo
yl
xg
HU
"}
(16,1,1) = {"
HU
xg
yl
Zo
xM
xg
ei
yl
hS
hS
yl
hS
yl
hS
hS
yl
ei
xg
xM
Zo
yl
xg
HU
"}
(17,1,1) = {"
HU
xg
Fc
Zo
Zo
xg
ER
yl
TX
ei
yl
TX
yl
ei
TX
yl
ER
xg
Zo
yl
Fc
xg
HU
"}
(18,1,1) = {"
HU
xg
xg
yl
Zo
xg
xg
ks
xg
ER
yl
xg
yl
ER
xg
ks
xg
xg
Zo
yl
xg
xg
HU
"}
(19,1,1) = {"
HU
xg
xg
yl
CT
Zo
Zo
xM
xg
xg
ks
xg
ks
xg
xg
xM
Zo
Zo
CT
yl
xg
xg
HU
"}
(20,1,1) = {"
HU
xg
xg
yl
gN
CT
Zo
Zo
Zo
Zo
Zo
Zo
Zo
Zo
Zo
Zo
Zo
CT
gN
yl
xg
xg
HU
"}
(21,1,1) = {"
HU
xg
xg
rp
yl
yl
yl
yl
yl
yl
yl
yl
yl
yl
yl
yl
yl
yl
yl
rp
xg
xg
HU
"}
(22,1,1) = {"
HU
xg
xg
xg
xg
xg
xg
xg
xg
xg
xg
xg
xg
xg
xg
xg
xg
xg
xg
xg
xg
xg
HU
"}
(23,1,1) = {"
HU
HU
HU
HU
HU
HU
HU
HU
HU
HU
HU
HU
HU
HU
HU
HU
HU
HU
HU
HU
HU
HU
HU
"}
