//MAP CONVERTED BY dmm2tgm.py THIS HEADER COMMENT PREVENTS RECONVERSION, DO NOT REMOVE
"a" = (
/turf/unsimulated/wall,
/area/mafia)
"b" = (
/turf/unsimulated/wall/fakealien,
/area/mafia)
"j" = (
/obj/structure/mineral_door/resin,
/obj/effect/landmark/blockway,
/turf/unsimulated/wall/fakealien,
/area/mafia)
"p" = (
/obj/machinery/door/poddoor/mafia,
/turf/unsimulated/wall/fakealienmembrane,
/area/mafia)
"t" = (
/obj/structure/alien{
	desc = "It looks like a weird egg";
	icon_state = "egg";
	name = "egg"
	},
/turf/unsimulated/floor/fakealien/weednode,
/area/mafia)
"u" = (
/obj/effect/landmark/mafia/town_center,
/turf/unsimulated/floor/fakealien,
/area/mafia)
"v" = (
/obj/mafia_game_board,
/obj/structure/stool/bed/nest,
/turf/unsimulated/floor/fakealien,
/area/mafia)
"w" = (
/obj/effect/landmark/mafia,
/turf/unsimulated/floor/fakealien/weednode,
/area/mafia)
"y" = (
/obj/structure/alien{
	desc = "It looks like a weird egg";
	icon_state = "egg_hatched";
	name = "egg"
	},
/obj/item/clothing/mask/facehugger_toy,
/turf/unsimulated/floor/fakealien,
/area/mafia)
"F" = (
/obj/structure/alien{
	desc = "It looks like a weird egg";
	icon_state = "egg";
	name = "egg"
	},
/turf/unsimulated/floor/fakealien,
/area/mafia)
"H" = (
/obj/structure/stool/bed/nest,
/turf/unsimulated/floor/fakealien,
/area/mafia)
"N" = (
/turf/unsimulated/floor/fakealien/weednode,
/area/mafia)
"O" = (
/obj/effect/landmark/mafia,
/turf/unsimulated/floor/fakealien,
/area/mafia)
"P" = (
/obj/structure/stool/bed/nest,
/turf/unsimulated/floor/fakealien/weednode,
/area/mafia)
"T" = (
/obj/structure/alien/air_plant,
/turf/unsimulated/floor/fakealien,
/area/mafia)
"X" = (
/turf/unsimulated/floor/fakealien,
/area/mafia)

(1,1,1) = {"
a
a
a
a
a
a
a
a
a
a
a
a
a
a
a
a
a
a
a
a
a
a
a
"}
(2,1,1) = {"
a
b
b
b
b
b
b
b
b
b
b
b
b
b
b
b
b
b
b
b
b
b
a
"}
(3,1,1) = {"
a
b
b
N
X
X
X
N
X
X
X
X
N
X
X
X
X
N
X
X
b
b
a
"}
(4,1,1) = {"
a
b
b
X
v
N
X
X
X
N
X
X
X
X
N
X
X
X
v
N
b
b
a
"}
(5,1,1) = {"
a
b
b
X
X
X
X
X
b
b
j
b
j
b
b
X
N
X
X
X
b
b
a
"}
(6,1,1) = {"
a
b
b
N
X
b
b
j
b
H
X
b
X
P
b
j
b
b
X
X
b
b
a
"}
(7,1,1) = {"
a
b
b
X
X
b
P
X
p
O
N
p
X
O
p
X
H
b
N
X
X
b
a
"}
(8,1,1) = {"
a
b
X
X
N
b
O
X
b
b
T
b
N
b
b
N
O
b
X
X
X
b
a
"}
(9,1,1) = {"
a
b
X
X
b
b
p
T
N
p
X
p
X
p
N
T
p
b
b
X
N
b
a
"}
(10,1,1) = {"
a
b
N
X
b
P
p
b
p
p
p
p
p
p
p
b
p
H
b
X
X
b
a
"}
(11,1,1) = {"
a
b
X
X
j
O
X
N
X
p
t
F
y
p
X
N
X
w
j
X
X
b
a
"}
(12,1,1) = {"
a
b
X
X
b
b
p
b
p
p
F
u
t
p
p
b
p
b
b
X
N
b
a
"}
(13,1,1) = {"
a
b
X
X
j
O
N
T
X
p
F
t
F
p
N
X
X
O
j
X
X
b
a
"}
(14,1,1) = {"
a
b
X
N
b
H
p
b
p
p
p
p
p
p
p
b
p
H
b
N
X
b
a
"}
(15,1,1) = {"
a
b
X
X
b
b
p
N
X
p
X
p
N
p
X
N
p
b
b
X
X
b
a
"}
(16,1,1) = {"
a
b
N
X
X
b
O
X
b
b
N
b
X
b
b
X
O
b
X
X
X
b
a
"}
(17,1,1) = {"
a
b
X
X
X
b
H
X
p
O
X
p
T
w
p
N
H
b
N
X
X
b
a
"}
(18,1,1) = {"
a
b
b
X
N
b
b
j
b
P
X
b
N
H
b
j
b
b
X
X
b
b
a
"}
(19,1,1) = {"
a
b
b
X
X
X
N
X
b
b
j
b
j
b
b
N
X
N
X
X
b
b
a
"}
(20,1,1) = {"
a
b
b
N
v
X
X
X
N
X
X
N
X
X
X
X
X
X
v
N
b
b
a
"}
(21,1,1) = {"
a
b
b
X
X
N
X
X
X
X
X
X
X
N
X
X
N
X
X
X
b
b
a
"}
(22,1,1) = {"
a
b
b
b
b
b
b
b
b
b
b
b
b
b
b
b
b
b
b
b
b
b
a
"}
(23,1,1) = {"
a
a
a
a
a
a
a
a
a
a
a
a
a
a
a
a
a
a
a
a
a
a
a
"}
