//MAP CONVERTED BY dmm2tgm.py THIS HEADER COMMENT PREVENTS RECONVERSION, DO NOT REMOVE
"a" = (
/turf/space,
/area/space)
"b" = (
/turf/simulated/mineral/random/caves,
/area/space)
"c" = (
/turf/simulated/mineral/random/labormineral,
/area/space)
"d" = (
/turf/simulated/mineral/random/low_chance,
/area/space)
"e" = (
/turf/simulated/mineral/random/high_chance,
/area/space)
"f" = (
/obj/structure/inflatable/survival,
/turf/simulated/floor/pod,
/area/survivalpod)
"g" = (
/obj/structure/sign/mining/survival{
	dir = 1
	},
/obj/structure/inflatable/survival,
/turf/simulated/floor/pod,
/area/survivalpod)
"h" = (
/obj/structure/inflatable/survival,
/turf/simulated/floor/pod,
/area/space)
"i" = (
/turf/simulated/wall,
/area/space)
"j" = (
/obj/machinery/mineral/unloading_machine{
	icon_state = "unloader-corner"
	},
/turf/simulated/floor/plating/airless{
	icon_state = "asteroidplating"
	},
/area/space)
"k" = (
/obj/machinery/conveyor{
	dir = 4;
	id = "mining_external"
	},
/obj/machinery/mineral/input,
/turf/simulated/floor/plating/airless{
	icon_state = "asteroidplating"
	},
/area/space)
"l" = (
/turf/simulated/floor/plating/airless/asteroid,
/area/space)
"m" = (
/obj/structure/window/reinforced/tinted,
/obj/structure/window/reinforced/tinted{
	dir = 4
	},
/obj/structure/window/reinforced/tinted{
	dir = 1
	},
/obj/structure/window/reinforced/tinted{
	dir = 8
	},
/obj/structure/grille,
/turf/simulated/floor/plating/airless{
	icon_state = "asteroidplating"
	},
/area/space)
"n" = (
/obj/structure/fans,
/turf/simulated/floor/pod,
/area/survivalpod)
"o" = (
/obj/machinery/smartfridge/survival_pod,
/turf/simulated/floor/pod,
/area/survivalpod)
"p" = (
/turf/simulated/floor/pod,
/area/survivalpod)
"q" = (
/obj/structure/table,
/obj/item/device/flashlight/lamp,
/turf/simulated/floor/pod,
/area/space)
"r" = (
/obj/structure/table,
/obj/item/weapon/paper_bin,
/obj/item/weapon/pen,
/turf/simulated/floor/pod,
/area/space)
"t" = (
/obj/structure/window/reinforced{
	dir = 8
	},
/obj/structure/ore_box,
/turf/simulated/floor/plating/airless/asteroid,
/area/space)
"u" = (
/obj/structure/closet/crate,
/turf/simulated/floor/plating/airless/asteroid,
/area/space)
"v" = (
/obj/structure/window/reinforced{
	dir = 4
	},
/obj/structure/closet/crate,
/obj/item/weapon/pickaxe,
/obj/item/weapon/storage/bag/ore,
/turf/simulated/floor/plating/airless/asteroid,
/area/space)
"w" = (
/obj/structure/sign/mining/survival{
	dir = 8
	},
/obj/structure/inflatable/survival,
/turf/simulated/floor/pod,
/area/survivalpod)
"x" = (
/obj/structure/stool/bed/pod,
/obj/item/weapon/bedsheet,
/turf/simulated/floor/pod,
/area/survivalpod)
"y" = (
/obj/structure/inflatable/door/survival_pod,
/turf/simulated/floor/pod,
/area/survivalpod)
"z" = (
/turf/simulated/floor/pod,
/area/space)
"A" = (
/mob/living/simple_animal/hostile/mining_drone,
/turf/simulated/floor/pod,
/area/space)
"B" = (
/obj/structure/inflatable/survival,
/obj/structure/sign/mining/survival{
	dir = 4
	},
/turf/simulated/floor/pod,
/area/space)
"C" = (
/obj/machinery/conveyor{
	id = "mining_internal"
	},
/turf/simulated/floor/plating/airless/asteroid,
/area/space)
"D" = (
/obj/item/weapon/reagent_containers/glass/bucket,
/obj/item/weapon/shovel,
/turf/simulated/floor/plating/airless/asteroid,
/area/space)
"E" = (
/obj/structure/pit,
/turf/simulated/floor/plating/airless/asteroid,
/area/space)
"F" = (
/obj/structure/table,
/obj/item/weapon/wrench,
/obj/item/weapon/storage/firstaid/small_firstaid_kit/civilian,
/turf/simulated/floor/pod,
/area/survivalpod)
"G" = (
/obj/structure/stool/bed/chair/comfy/beige{
	dir = 8
	},
/turf/simulated/floor/pod,
/area/survivalpod)
"H" = (
/obj/structure/table,
/obj/item/rig_module/device/orescanner,
/obj/item/weapon/screwdriver,
/turf/simulated/floor/pod,
/area/space)
"I" = (
/obj/structure/table,
/obj/item/weapon/storage/toolbox/mechanical,
/turf/simulated/floor/pod,
/area/space)
"J" = (
/obj/machinery/mineral/input,
/obj/machinery/conveyor{
	id = "mining_internal"
	},
/obj/machinery/mineral/processing_unit_console{
	machinedir = 2;
	pixel_x = -32
	},
/turf/simulated/floor/plating/airless{
	icon_state = "asteroidplating"
	},
/area/space)
"K" = (
/obj/structure/sign/mining/survival,
/obj/structure/inflatable/survival,
/turf/simulated/floor/pod,
/area/survivalpod)
"L" = (
/obj/structure/fans/tiny,
/obj/structure/inflatable/door/survival_pod,
/turf/simulated/floor/pod,
/area/survivalpod)
"M" = (
/obj/structure/sign/mining,
/obj/structure/inflatable/survival,
/turf/simulated/floor/pod,
/area/survivalpod)
"N" = (
/obj/machinery/mineral/processing_unit,
/turf/simulated/floor/plating/airless{
	icon_state = "asteroidplating"
	},
/area/space)
"O" = (
/obj/machinery/conveyor{
	id = "mining_internal"
	},
/obj/machinery/mineral/output,
/turf/simulated/floor/plating/airless{
	icon_state = "asteroidplating"
	},
/area/space)

(1,1,1) = {"
a
a
a
a
a
a
a
a
a
a
a
a
a
a
a
a
a
a
a
a
a
a
a
a
a
a
a
a
a
a
a
a
a
a
a
a
a
a
a
a
a
a
a
a
a
a
a
a
a
a
"}
(2,1,1) = {"
a
a
a
a
a
a
a
a
a
a
a
a
a
a
a
a
a
a
a
a
a
a
a
a
a
a
a
a
a
a
a
a
a
a
a
a
a
a
a
a
a
a
a
a
a
a
a
a
a
a
"}
(3,1,1) = {"
a
a
a
a
a
a
a
a
a
a
a
a
a
a
a
a
a
a
a
a
a
a
a
a
b
b
b
b
b
b
a
a
a
a
a
a
a
a
a
a
a
a
a
a
a
a
a
a
a
a
"}
(4,1,1) = {"
a
a
a
a
a
a
a
a
a
a
a
a
a
a
a
a
a
a
a
b
b
b
b
b
b
b
b
b
b
b
b
b
b
b
a
a
a
a
a
a
a
a
a
a
a
a
a
a
a
a
"}
(5,1,1) = {"
a
a
a
a
a
a
a
a
a
a
a
a
a
a
a
a
a
a
b
b
b
b
b
b
c
c
c
c
c
c
c
b
b
b
b
b
b
b
a
a
a
a
a
a
a
a
a
a
a
a
"}
(6,1,1) = {"
a
a
a
a
a
a
a
a
a
a
a
a
a
a
a
b
b
b
b
c
c
c
c
c
c
c
c
c
c
c
c
c
c
c
c
c
c
b
b
a
a
a
a
a
a
a
a
a
a
a
"}
(7,1,1) = {"
a
a
a
a
a
a
a
a
a
a
a
a
a
a
a
b
b
b
b
c
c
c
c
c
c
c
d
d
d
d
d
e
c
c
c
c
c
c
b
b
a
a
a
a
a
a
a
a
a
a
"}
(8,1,1) = {"
a
a
a
a
a
a
a
a
a
a
a
a
a
a
a
b
b
c
c
c
c
c
d
d
d
d
d
d
d
d
d
d
d
c
c
c
c
c
c
b
a
a
a
a
a
a
a
a
a
a
"}
(9,1,1) = {"
a
a
a
a
a
a
a
a
a
a
a
b
b
b
b
b
b
c
c
d
d
d
d
d
d
d
d
d
d
d
d
d
d
d
c
c
c
c
c
b
a
a
a
a
a
a
a
a
a
a
"}
(10,1,1) = {"
a
a
a
a
a
a
a
a
a
a
b
b
b
b
b
b
c
c
c
d
d
d
d
d
e
d
d
d
d
d
d
d
d
d
c
c
c
c
b
b
l
a
a
a
a
a
a
a
a
a
"}
(11,1,1) = {"
a
a
a
a
a
a
a
a
a
b
b
b
c
c
c
c
c
c
d
e
d
d
d
d
d
d
d
d
d
d
d
d
d
c
c
b
b
b
b
b
l
l
l
a
a
a
a
a
a
a
"}
(12,1,1) = {"
a
a
a
a
a
a
a
a
b
b
b
c
c
c
c
c
d
d
d
d
d
d
d
d
d
d
e
d
d
d
d
d
d
c
b
b
i
l
l
i
i
i
l
a
a
a
a
a
a
a
"}
(13,1,1) = {"
a
a
a
a
a
a
a
a
b
b
b
c
c
c
d
d
d
d
d
d
d
e
d
d
d
d
e
d
d
d
d
c
c
c
b
b
j
O
C
J
N
O
l
l
a
a
a
a
a
a
"}
(14,1,1) = {"
a
a
a
a
a
a
a
b
b
b
c
c
c
c
d
d
d
d
d
d
d
e
e
e
d
d
d
d
d
d
d
c
c
b
b
b
k
l
l
l
l
l
l
l
a
a
a
a
a
a
"}
(15,1,1) = {"
a
a
a
a
a
a
a
b
b
c
c
c
c
c
d
d
d
d
d
d
e
d
d
d
d
d
e
d
d
d
d
c
c
b
b
b
l
l
l
l
l
e
l
l
l
a
a
a
a
a
"}
(16,1,1) = {"
a
a
a
a
a
a
b
b
b
c
c
c
c
d
d
d
d
d
e
d
d
e
d
d
d
d
e
d
d
d
d
c
c
b
b
b
l
l
l
l
e
e
e
e
l
l
a
a
a
a
"}
(17,1,1) = {"
a
a
a
a
a
b
b
b
c
c
c
d
d
d
d
d
d
e
d
d
d
d
d
e
d
d
d
d
d
d
d
c
c
b
b
b
i
t
l
l
e
e
e
e
e
l
a
a
a
a
"}
(18,1,1) = {"
a
a
a
a
b
b
b
b
c
c
c
d
d
d
e
d
d
d
d
d
e
d
d
d
d
e
d
d
d
d
d
c
c
b
b
b
m
u
l
e
e
e
e
e
l
l
a
a
a
a
"}
(19,1,1) = {"
a
a
a
a
b
b
c
c
c
d
d
d
d
d
d
d
d
d
d
d
d
d
d
d
d
d
d
e
d
d
d
c
c
b
b
b
i
v
l
l
e
e
l
e
l
l
a
a
a
a
"}
(20,1,1) = {"
a
a
a
a
b
b
c
c
c
d
d
d
d
d
d
d
d
d
d
d
d
d
d
d
d
d
d
d
d
d
d
d
c
b
b
b
b
b
D
l
l
l
l
l
l
l
a
a
a
a
"}
(21,1,1) = {"
a
a
a
a
b
b
c
c
d
d
d
d
d
d
d
d
d
e
d
d
e
d
d
d
e
e
d
d
d
d
d
d
c
b
b
b
b
b
E
l
l
l
l
l
l
a
a
a
a
a
"}
(22,1,1) = {"
a
a
a
a
b
b
c
c
c
d
d
d
d
d
e
d
e
e
d
d
d
d
d
d
d
d
d
d
e
d
d
d
c
b
b
f
f
w
f
f
l
l
l
l
l
a
a
a
a
a
"}
(23,1,1) = {"
a
a
a
a
b
b
c
c
d
d
e
d
d
d
d
d
d
d
d
d
d
d
d
d
d
d
d
d
e
d
d
d
c
b
b
f
n
x
F
K
l
l
l
l
l
a
a
a
a
a
"}
(24,1,1) = {"
a
a
a
a
b
b
c
c
d
d
d
d
e
d
d
d
d
d
d
d
d
d
e
d
d
d
d
d
d
d
d
d
c
b
b
g
o
p
p
L
l
l
l
l
l
a
a
a
a
a
"}
(25,1,1) = {"
a
a
a
a
b
b
c
c
d
d
d
d
d
d
d
d
e
d
d
d
d
d
d
d
d
d
d
d
d
d
d
d
c
b
b
f
p
p
G
M
l
l
l
l
a
a
a
a
a
a
"}
(26,1,1) = {"
a
a
a
b
b
b
c
c
d
d
d
d
d
d
d
d
e
d
d
d
d
d
d
d
d
d
e
d
d
d
d
d
c
b
b
f
f
y
f
f
l
l
l
l
a
a
a
a
a
a
"}
(27,1,1) = {"
a
a
a
b
b
c
c
c
d
d
d
d
d
d
d
d
d
d
d
d
e
d
d
d
e
d
d
d
d
d
d
d
c
b
b
h
q
z
H
h
l
l
b
l
a
a
a
a
a
a
"}
(28,1,1) = {"
a
a
a
b
b
c
c
c
c
c
d
d
d
d
d
d
d
d
d
d
d
d
d
d
d
d
d
d
d
e
d
d
c
b
b
h
r
A
I
h
l
b
b
l
a
a
a
a
a
a
"}
(29,1,1) = {"
a
a
a
b
b
c
c
c
c
c
d
d
d
d
d
d
d
d
d
d
e
d
d
d
d
d
e
d
d
d
d
d
c
b
b
h
h
B
h
h
b
b
b
l
a
a
a
a
a
a
"}
(30,1,1) = {"
a
a
a
b
b
c
c
c
c
c
d
d
d
d
d
d
d
d
d
d
d
d
d
d
d
d
d
d
d
d
d
d
c
c
b
b
b
b
b
b
b
b
b
a
a
a
a
a
a
a
"}
(31,1,1) = {"
a
a
a
b
b
b
b
c
c
c
c
d
d
d
d
d
d
e
e
d
d
d
d
d
e
d
d
d
d
c
c
c
c
c
c
b
b
b
b
b
b
b
a
a
a
a
a
a
a
a
"}
(32,1,1) = {"
a
a
a
a
b
b
b
c
c
c
c
c
c
d
d
d
d
d
d
d
d
e
d
d
d
d
d
d
d
c
c
c
c
c
c
c
b
b
b
b
b
a
a
a
a
a
a
a
a
a
"}
(33,1,1) = {"
a
a
a
a
b
b
b
c
c
c
c
c
c
d
d
d
d
d
d
d
d
d
d
d
d
d
d
d
d
c
c
c
c
c
c
c
c
b
b
a
a
a
a
a
a
a
a
a
a
a
"}
(34,1,1) = {"
a
a
a
a
a
b
b
b
c
c
c
c
c
d
d
d
d
d
d
d
d
d
d
d
d
d
d
d
c
c
c
c
c
c
c
c
b
b
b
a
a
a
a
a
a
a
a
a
a
a
"}
(35,1,1) = {"
a
a
a
a
a
a
b
b
c
c
c
c
c
c
c
c
c
c
d
d
d
d
d
d
c
c
c
c
c
c
c
c
c
c
c
c
b
b
a
a
a
a
a
a
a
a
a
a
a
a
"}
(36,1,1) = {"
a
a
a
a
a
a
b
b
b
c
c
c
c
c
c
c
c
c
c
c
c
c
c
c
c
c
c
c
c
c
c
c
c
c
c
b
b
b
a
a
a
a
a
a
a
a
a
a
a
a
"}
(37,1,1) = {"
a
a
a
a
a
a
a
b
b
b
b
c
c
c
c
c
c
c
c
c
c
c
c
c
c
c
c
c
c
c
c
c
c
c
c
b
b
a
a
a
a
a
a
a
a
a
a
a
a
a
"}
(38,1,1) = {"
a
a
a
a
a
a
a
a
b
b
b
b
c
c
c
c
c
c
c
c
c
c
c
c
c
c
c
c
c
c
c
c
c
c
b
b
b
a
a
a
a
a
a
a
a
a
a
a
a
a
"}
(39,1,1) = {"
a
a
a
a
a
a
a
a
a
b
b
b
c
c
c
c
c
c
c
c
c
c
c
c
c
c
c
c
c
c
c
c
c
b
b
b
a
a
a
a
a
a
a
a
a
a
a
a
a
a
"}
(40,1,1) = {"
a
a
a
a
a
a
a
a
a
a
b
b
b
c
c
c
c
c
c
c
c
c
c
c
c
c
c
c
c
c
b
b
b
b
b
a
a
a
a
a
a
a
a
a
a
a
a
a
a
a
"}
(41,1,1) = {"
a
a
a
a
a
a
a
a
a
a
a
b
b
b
c
c
c
c
c
c
c
c
c
c
c
c
c
c
b
b
b
b
b
b
a
a
a
a
a
a
a
a
a
a
a
a
a
a
a
a
"}
(42,1,1) = {"
a
a
a
a
a
a
a
a
a
a
a
a
b
b
b
b
b
b
b
c
c
c
c
c
b
b
b
b
b
b
b
b
a
a
a
a
a
a
a
a
a
a
a
a
a
a
a
a
a
a
"}
(43,1,1) = {"
a
a
a
a
a
a
a
a
a
a
a
a
a
b
b
b
b
b
b
c
c
c
b
b
b
b
b
b
b
b
a
a
a
a
a
a
a
a
a
a
a
a
a
a
a
a
a
a
a
a
"}
(44,1,1) = {"
a
a
a
a
a
a
a
a
a
a
a
a
a
a
a
b
b
b
b
b
b
b
b
b
b
a
a
a
a
a
a
a
a
a
a
a
a
a
a
a
a
a
a
a
a
a
a
a
a
a
"}
(45,1,1) = {"
a
a
a
a
a
a
a
a
a
a
a
a
a
a
a
a
a
b
b
b
b
b
b
b
a
a
a
a
a
a
a
a
a
a
a
a
a
a
a
a
a
a
a
a
a
a
a
a
a
a
"}
(46,1,1) = {"
a
a
a
a
a
a
a
a
a
a
a
a
a
a
a
a
a
a
a
b
b
b
b
a
a
a
a
a
a
a
a
a
a
a
a
a
a
a
a
a
a
a
a
a
a
a
a
a
a
a
"}
(47,1,1) = {"
a
a
a
a
a
a
a
a
a
a
a
a
a
a
a
a
a
a
a
a
a
a
a
a
a
a
a
a
a
a
a
a
a
a
a
a
a
a
a
a
a
a
a
a
a
a
a
a
a
a
"}
(48,1,1) = {"
a
a
a
a
a
a
a
a
a
a
a
a
a
a
a
a
a
a
a
a
a
a
a
a
a
a
a
a
a
a
a
a
a
a
a
a
a
a
a
a
a
a
a
a
a
a
a
a
a
a
"}
(49,1,1) = {"
a
a
a
a
a
a
a
a
a
a
a
a
a
a
a
a
a
a
a
a
a
a
a
a
a
a
a
a
a
a
a
a
a
a
a
a
a
a
a
a
a
a
a
a
a
a
a
a
a
a
"}
(50,1,1) = {"
a
a
a
a
a
a
a
a
a
a
a
a
a
a
a
a
a
a
a
a
a
a
a
a
a
a
a
a
a
a
a
a
a
a
a
a
a
a
a
a
a
a
a
a
a
a
a
a
a
a
"}
