//MAP CONVERTED BY dmm2tgm.py THIS HEADER COMMENT PREVENTS RECONVERSION, DO NOT REMOVE
"a" = (
/turf/space,
/area/space)
"b" = (
/turf/simulated/floor/plating/ironsand{
	icon_state = "ironsand11"
	},
/area/space)
"c" = (
/turf/simulated/mineral,
/area/space)
"d" = (
/turf/simulated/floor/plating/ironsand{
	icon_state = "ironsand14"
	},
/area/space)
"e" = (
/obj/item/weapon/ore/strangerock,
/turf/simulated/floor/plating/ironsand,
/area/space)
"f" = (
/turf/simulated/floor/plating/ironsand,
/area/space)
"g" = (
/turf/simulated/floor/plating/ironsand{
	icon_state = "ironsand9"
	},
/area/space)
"h" = (
/obj/item/weapon/ore/strangerock,
/turf/simulated/floor/plating/ironsand{
	icon_state = "ironsand11"
	},
/area/space)

(1,1,1) = {"
a
a
a
a
c
d
a
"}
(2,1,1) = {"
a
a
a
a
h
g
a
"}
(3,1,1) = {"
a
a
c
c
c
a
a
"}
(4,1,1) = {"
a
b
d
f
c
d
c
"}
(5,1,1) = {"
a
c
b
g
d
h
a
"}
(6,1,1) = {"
a
c
e
d
a
a
a
"}
(7,1,1) = {"
a
a
a
a
a
c
c
"}
