//MAP CONVERTED BY dmm2tgm.py THIS HEADER COMMENT PREVENTS RECONVERSION, DO NOT REMOVE
"a" = (
/turf/simulated/floor/plating/ironsand/junkyard,
/area/awaymission/junkyard/structure)
"b" = (
/turf/simulated/wall/r_wall,
/area/awaymission/junkyard/structure)
"c" = (
/obj/structure/lattice,
/turf/simulated/floor/plating/ironsand/junkyard,
/area/awaymission/junkyard/structure)
"d" = (
/obj/structure/computerframe,
/obj/structure/cable{
	d2 = 2;
	icon_state = "0-2"
	},
/turf/simulated/floor/plating,
/area/awaymission/junkyard/structure)
"e" = (
/obj/machinery/teleport/station,
/obj/structure/cable{
	d2 = 2;
	icon_state = "0-2"
	},
/turf/simulated/floor/plating,
/area/awaymission/junkyard/structure)
"f" = (
/turf/simulated/floor/plating,
/area/awaymission/junkyard/structure)
"g" = (
/obj/item/weapon/shard{
	icon_state = "medium"
	},
/turf/simulated/floor/plating,
/area/awaymission/junkyard/structure)
"h" = (
/obj/structure/cable,
/turf/simulated/floor/plating,
/area/awaymission/junkyard/structure)
"i" = (
/obj/structure/rack,
/obj/item/clothing/gloves/yellow,
/turf/simulated/floor/plating,
/area/awaymission/junkyard/structure)
"j" = (
/obj/structure/girder,
/turf/simulated/floor/plating,
/area/awaymission/junkyard/structure)
"k" = (
/obj/item/weapon/stock_parts/cell,
/turf/simulated/floor/plating,
/area/awaymission/junkyard/structure)
"l" = (
/obj/structure/grille{
	destroyed = 1
	},
/turf/simulated/floor/plating,
/area/awaymission/junkyard/structure)
"m" = (
/obj/item/weapon/table_parts,
/turf/simulated/floor/plating,
/area/awaymission/junkyard/structure)
"n" = (
/obj/item/weapon/disk/research_points,
/turf/simulated/floor/plating,
/area/awaymission/junkyard/structure)
"o" = (
/obj/structure/closet,
/turf/simulated/floor/plating,
/area/awaymission/junkyard/structure)
"p" = (
/obj/structure/cable{
	d2 = 4;
	icon_state = "0-4"
	},
/turf/simulated/floor/plating,
/area/awaymission/junkyard/structure)
"q" = (
/obj/structure/grille{
	destroyed = 1
	},
/turf/simulated/floor/plating/ironsand/junkyard,
/area/awaymission/junkyard/structure)
"r" = (
/obj/item/weapon/storage/toolbox/electrical{
	pixel_x = 1;
	pixel_y = -1
	},
/turf/simulated/floor/plating,
/area/awaymission/junkyard/structure)

(1,1,1) = {"
a
a
c
a
a
a
c
a
a
a
a
a
"}
(2,1,1) = {"
a
a
c
a
a
a
c
a
a
a
a
a
"}
(3,1,1) = {"
a
c
c
a
a
a
c
c
a
a
a
a
"}
(4,1,1) = {"
a
c
b
j
f
b
b
c
a
a
a
a
"}
(5,1,1) = {"
a
b
b
k
f
n
b
b
a
a
a
a
"}
(6,1,1) = {"
b
b
g
f
f
c
p
b
b
c
a
a
"}
(7,1,1) = {"
b
d
f
l
c
c
q
f
b
a
c
a
"}
(8,1,1) = {"
b
e
h
a
c
a
a
c
f
c
c
c
"}
(9,1,1) = {"
b
f
f
f
c
c
c
f
b
a
c
a
"}
(10,1,1) = {"
b
b
i
f
f
a
r
b
b
c
a
a
"}
(11,1,1) = {"
c
b
b
m
f
o
b
b
c
a
a
a
"}
(12,1,1) = {"
a
a
b
b
b
b
b
a
a
a
a
a
"}
