"a" = (/turf/simulated/floor/plating/ironsand/junkyard,/area/awaymission/junkyard)
"b" = (/turf/simulated/wall/r_wall,/area/awaymission/junkyard)
"c" = (/obj/structure/lattice,/turf/simulated/floor/plating/ironsand/junkyard,/area/awaymission/junkyard)
"d" = (/obj/structure/computerframe,/obj/structure/cable{d2 = 2; icon_state = "0-2"},/turf/simulated/floor/plating/airless,/area/awaymission/junkyard)
"e" = (/obj/machinery/teleport/station,/obj/structure/cable{d2 = 2; icon_state = "0-2"},/turf/simulated/floor/plating/airless,/area/awaymission/junkyard)
"f" = (/turf/simulated/floor/plating/airless,/area/awaymission/junkyard)
"g" = (/obj/item/weapon/shard{icon_state = "medium"},/turf/simulated/floor/plating/airless,/area/awaymission/junkyard)
"h" = (/obj/structure/cable,/turf/simulated/floor/plating/airless,/area/awaymission/junkyard)
"i" = (/obj/structure/rack,/obj/item/clothing/gloves/yellow,/turf/simulated/floor/plating/airless,/area/awaymission/junkyard)
"j" = (/obj/structure/girder,/turf/simulated/floor/plating/airless,/area/awaymission/junkyard)
"k" = (/obj/item/weapon/stock_parts/cell,/turf/simulated/floor/plating/airless,/area/awaymission/junkyard)
"l" = (/obj/structure/grille{destroyed = 1},/turf/simulated/floor/plating/airless,/area/awaymission/junkyard)
"m" = (/obj/item/weapon/table_parts,/turf/simulated/floor/plating/airless,/area/awaymission/junkyard)
"n" = (/obj/item/weapon/disk/research_points,/turf/simulated/floor/plating/airless,/area/awaymission/junkyard)
"o" = (/obj/structure/closet,/turf/simulated/floor/plating/airless,/area/awaymission/junkyard)
"p" = (/obj/structure/cable{d2 = 4; icon_state = "0-4"},/turf/simulated/floor/plating/airless,/area/awaymission/junkyard)
"q" = (/obj/structure/grille{destroyed = 1},/turf/simulated/floor/plating/ironsand/junkyard,/area/awaymission/junkyard)
"r" = (/obj/item/weapon/storage/toolbox/electrical{pixel_x = 1; pixel_y = -1},/turf/simulated/floor/plating/airless,/area/awaymission/junkyard)

(1,1,1) = {"
aaaaabbbbbca
aaccbbdefbba
cccbbgfhfibb
aaajkflaffmb
aaafffcccffb
aaabnccacaob
cccbbpqacrbb
aaccbbfcfbba
aaaaabbfbbca
aaaaacacacaa
aaaaaacccaaa
aaaaaaacaaaa
"}
