//MAP CONVERTED BY dmm2tgm.py THIS HEADER COMMENT PREVENTS RECONVERSION, DO NOT REMOVE
"a" = (
/turf/simulated/floor/plating/ironsand/junkyard,
/area/awaymission/junkyard/structure)
"b" = (
/obj/structure/shuttle/engine/heater,
/obj/structure/window/reinforced{
	dir = 4
	},
/obj/structure/window/reinforced{
	dir = 1
	},
/obj/structure/window/reinforced{
	dir = 8;
	req_access = list(72)
	},
/turf/simulated/floor/plating,
/area/agrospheregarden)
"c" = (
/turf/simulated/wall,
/area/agrospheregarden)
"d" = (
/obj/machinery/door/airlock/external,
/turf/simulated/floor/plating,
/area/agrospheregarden)
"e" = (
/obj/structure/shuttle/engine/propulsion,
/turf/simulated/floor/plating,
/area/agrospheregarden)
"f" = (
/turf/simulated/floor/plating,
/area/agrospheregarden)
"g" = (
/obj/structure/shuttle/engine/propulsion{
	dir = 1
	},
/turf/simulated/floor/plating,
/area/agrospheregarden)
"h" = (
/obj/structure/shuttle/engine/heater{
	dir = 1
	},
/obj/structure/window/reinforced{
	dir = 4
	},
/obj/structure/window/reinforced{
	dir = 8;
	req_access = list(72)
	},
/obj/structure/window/reinforced,
/turf/simulated/floor/plating,
/area/agrospheregarden)
"i" = (
/obj/structure/grille,
/obj/structure/window/reinforced{
	dir = 5
	},
/turf/simulated/floor/plating,
/area/agrospheregarden)
"j" = (
/turf/simulated/floor/grass,
/area/agrospheregarden)
"k" = (
/obj/item/weapon/reagent_containers/food/snacks/grown/thaadrabloom,
/turf/simulated/floor/grass,
/area/agrospheregarden)
"l" = (
/obj/structure/flora/ausbushes/lavendergrass,
/turf/simulated/floor/grass,
/area/agrospheregarden)
"m" = (
/obj/machinery/light{
	dir = 8
	},
/turf/simulated/floor/grass,
/area/agrospheregarden)
"n" = (
/obj/item/weapon/reagent_containers/food/snacks/grown/harebell,
/turf/simulated/floor/grass,
/area/agrospheregarden)
"o" = (
/obj/structure/flora/ausbushes/lavendergrass,
/obj/machinery/light{
	dir = 4
	},
/turf/simulated/floor/grass,
/area/agrospheregarden)
"p" = (
/obj/structure/shuttle/engine/propulsion{
	dir = 8
	},
/turf/simulated/floor/plating,
/area/agrospheregarden)
"q" = (
/obj/structure/shuttle/engine/heater{
	dir = 8
	},
/obj/structure/window/reinforced{
	dir = 1
	},
/obj/structure/window/reinforced{
	dir = 4
	},
/obj/structure/window/reinforced,
/turf/simulated/floor/plating,
/area/agrospheregarden)
"r" = (
/obj/item/weapon/reagent_containers/food/snacks/grown/mtear,
/turf/simulated/floor/grass,
/area/agrospheregarden)
"s" = (
/obj/structure/flora/junglebush/c,
/turf/simulated/floor/grass,
/area/agrospheregarden)
"t" = (
/obj/structure/flora/tree/jungle,
/turf/simulated/floor/grass,
/area/agrospheregarden)
"u" = (
/obj/structure/shuttle/engine/heater{
	dir = 4
	},
/obj/structure/window/reinforced{
	dir = 1
	},
/obj/structure/window/reinforced{
	dir = 8;
	req_access = list(72)
	},
/obj/structure/window/reinforced,
/turf/simulated/floor/plating,
/area/agrospheregarden)
"v" = (
/obj/structure/shuttle/engine/propulsion{
	dir = 4
	},
/turf/simulated/floor/plating,
/area/agrospheregarden)
"w" = (
/obj/item/weapon/reagent_containers/food/snacks/grown/mushroom/chanterelle,
/turf/simulated/floor/grass,
/area/agrospheregarden)
"x" = (
/obj/structure/flora/junglebush/large,
/turf/simulated/floor/grass,
/area/agrospheregarden)
"y" = (
/obj/item/weapon/reagent_containers/food/snacks/grown/mushroom/chanterelle{
	pixel_x = -15;
	pixel_y = 15
	},
/turf/simulated/floor/grass,
/area/agrospheregarden)
"z" = (
/obj/structure/flora/tree/jungle/small,
/turf/simulated/floor/grass,
/area/agrospheregarden)
"A" = (
/obj/structure/flora/ausbushes/lavendergrass,
/obj/machinery/light{
	dir = 8
	},
/turf/simulated/floor/grass,
/area/agrospheregarden)
"B" = (
/obj/item/weapon/reagent_containers/food/snacks/grown/thaadrabloom{
	pixel_x = 6;
	pixel_y = -5
	},
/turf/simulated/floor/grass,
/area/agrospheregarden)
"C" = (
/obj/item/weapon/reagent_containers/food/snacks/grown/mushroom/libertycap,
/turf/simulated/floor/grass,
/area/agrospheregarden)
"D" = (
/obj/machinery/light{
	dir = 4
	},
/obj/item/weapon/reagent_containers/food/snacks/grown/thaadrabloom,
/turf/simulated/floor/grass,
/area/agrospheregarden)
"E" = (
/obj/structure/flora/ausbushes/lavendergrass,
/obj/item/weapon/reagent_containers/food/snacks/grown/mushroom/libertycap,
/turf/simulated/floor/grass,
/area/agrospheregarden)
"F" = (
/obj/item/weapon/reagent_containers/food/snacks/grown/mushroom/libertycap{
	pixel_x = -20;
	pixel_y = 10
	},
/turf/simulated/floor/grass,
/area/agrospheregarden)
"G" = (
/obj/structure/flora/ausbushes/lavendergrass,
/obj/structure/flora/tree/jungle/small,
/turf/simulated/floor/grass,
/area/agrospheregarden)
"H" = (
/obj/item/weapon/reagent_containers/food/snacks/grown/harebell{
	pixel_x = 6;
	pixel_y = 7
	},
/turf/simulated/floor/grass,
/area/agrospheregarden)
"I" = (
/obj/machinery/light{
	dir = 4
	},
/turf/simulated/floor/grass,
/area/agrospheregarden)

(1,1,1) = {"
a
a
a
a
a
a
a
a
p
a
a
a
a
a
p
a
a
a
a
a
a
a
a
"}
(2,1,1) = {"
a
a
a
a
a
a
a
a
q
i
i
i
i
i
q
a
a
a
a
a
a
a
a
"}
(3,1,1) = {"
a
a
a
a
a
a
a
a
c
i
j
A
n
i
c
a
a
a
a
a
a
a
a
"}
(4,1,1) = {"
a
a
a
a
a
a
a
i
i
j
x
j
s
j
i
i
a
a
a
a
a
a
a
"}
(5,1,1) = {"
a
a
a
a
a
a
i
i
r
j
x
j
j
j
x
i
i
a
a
a
a
a
a
"}
(6,1,1) = {"
a
a
a
a
a
i
i
m
j
j
j
j
j
t
j
m
i
i
a
a
a
a
a
"}
(7,1,1) = {"
b
e
g
h
i
i
j
j
s
t
j
j
j
j
j
x
k
i
b
e
a
a
a
"}
(8,1,1) = {"
c
c
c
c
c
j
j
j
j
w
y
r
j
j
G
j
j
l
c
c
c
c
c
"}
(9,1,1) = {"
c
f
f
c
j
k
l
j
j
j
l
j
j
j
j
H
s
j
j
c
f
f
c
"}
(10,1,1) = {"
d
f
f
d
j
j
j
n
j
j
j
B
l
j
j
j
j
j
j
d
f
f
d
"}
(11,1,1) = {"
c
f
f
c
j
j
j
j
j
j
z
j
j
j
j
j
j
k
j
c
f
f
c
"}
(12,1,1) = {"
c
c
c
c
c
j
j
j
t
j
j
l
j
j
j
t
x
j
c
c
c
c
c
"}
(13,1,1) = {"
b
e
g
h
i
i
j
j
s
j
l
n
j
x
j
l
j
i
b
e
a
a
a
"}
(14,1,1) = {"
a
a
a
a
a
i
i
o
j
j
j
C
s
j
j
I
i
i
a
a
a
a
a
"}
(15,1,1) = {"
a
a
a
a
a
a
i
i
j
j
j
t
E
j
r
i
i
a
a
a
a
a
a
"}
(16,1,1) = {"
a
a
a
a
a
a
a
i
i
j
l
l
F
l
i
i
a
a
a
a
a
a
a
"}
(17,1,1) = {"
a
a
a
a
a
a
a
a
c
i
j
D
x
i
c
a
a
a
a
a
a
a
a
"}
(18,1,1) = {"
a
a
a
a
a
a
a
a
u
i
i
i
i
i
u
a
a
a
a
a
a
a
a
"}
(19,1,1) = {"
a
a
a
a
a
a
a
a
v
a
a
a
a
a
v
a
a
a
a
a
a
a
a
"}
