"aa" = (/turf/simulated/floor/plating/ironsand/junkyard,/area/awaymission/junkyard/structure)
"ab" = (/turf/simulated/shuttle/wall{icon_state = "swall_f6"},/turf/simulated/floor/plating/ironsand/junkyard,/area/ghostship)
"ac" = (/turf/simulated/shuttle/wall{icon_state = "swall12"},/area/ghostship)
"ad" = (/turf/simulated/shuttle/wall{icon_state = "swall12"},/turf/simulated/floor/plating/ironsand/junkyard,/area/awaymission/junkyard/structure)
"ae" = (/turf/simulated/shuttle/wall{icon_state = "swall13"},/turf/simulated/floor/plating/ironsand/junkyard,/area/awaymission/junkyard/structure)
"af" = (/turf/simulated/floor/plating,/turf/simulated/floor/plating/ironsand/junkyard,/area/awaymission/junkyard/structure)
"ag" = (/turf/simulated/floor{icon_state = "damaged4"},/turf/simulated/floor/plating/ironsand/junkyard,/area/awaymission/junkyard/structure)
"ah" = (/turf/simulated/floor/plating,/obj/item/ammo_casing/a12mm,/obj/item/ammo_casing/a12mm{pixel_x = -4; pixel_y = 5},/turf/simulated/floor/plating/ironsand/junkyard,/area/awaymission/junkyard/structure)
"ai" = (/turf/simulated/floor/plating,/turf/simulated/shuttle/wall{icon_state = "swall_s9"},/area/ghostship)
"aj" = (/obj/structure/table/reinforced,/obj/item/weapon/paper,/turf/simulated/floor/plating,/area/ghostship)
"ak" = (/obj/structure/table/reinforced,/obj/item/weapon/paper_bin,/obj/item/weapon/pen,/obj/machinery/light_construct{dir = 1},/turf/simulated/floor/plating,/area/ghostship)
"al" = (/obj/machinery/blackbox_recorder,/obj/item/weapon/disk/research_points,/turf/simulated/floor/plating,/area/ghostship)
"am" = (/obj/structure/stool/bed/chair/schair/wagon{dir = 4},/turf/simulated/floor/plating,/area/ghostship)
"an" = (/obj/structure/computerframe{dir = 8},/turf/simulated/floor/plating,/area/ghostship)
"ao" = (/obj/structure/grille,/obj/structure/shuttle/window,/turf/simulated/floor/plating/airless,/area/ghostship)
"ap" = (/turf/simulated/floor/plating/ironsand/junkyard,/turf/simulated/shuttle/wall{icon_state = "swall_s6"},/area/ghostship)
"aq" = (/turf/simulated/shuttle/wall{icon_state = "swall14"},/area/ghostship)
"ar" = (/obj/structure/lattice,/turf/simulated/floor/plating/ironsand/junkyard,/area/awaymission/junkyard/structure)
"as" = (/turf/simulated/floor/plating/ironsand/junkyard,/turf/simulated/shuttle/wall{icon_state = "swall_s6"},/area/derelict/ship)
"at" = (/turf/simulated/shuttle/wall{icon_state = "swall11"},/area/ghostship)
"au" = (/obj/machinery/light_construct{dir = 8},/turf/simulated/floor{icon_state = "damaged4"},/area/ghostship)
"av" = (/turf/simulated/floor{icon_state = "damaged1"},/area/ghostship)
"aw" = (/turf/simulated/floor/plating/airless,/obj/structure/artilleryplaceholder{icon_state = "3"},/turf/simulated/floor/plating/ironsand/junkyard,/area/ghostship)
"ax" = (/turf/simulated/floor/plating,/obj/machinery/door/unpowered/shuttle/officer,/turf/simulated/floor/plating/ironsand/junkyard,/area/ghostship)
"ay" = (/turf/simulated/floor{icon_state = "engine"},/obj/structure/shuttle/engine/heater{dir = 8},/obj/structure/window/reinforced{dir = 4},/turf/simulated/floor/plating/ironsand/junkyard,/area/ghostship)
"az" = (/turf/simulated/floor{icon_state = "damaged1"},/turf/simulated/floor/plating/ironsand/junkyard,/area/awaymission/junkyard/structure)
"aA" = (/turf/simulated/floor{icon_state = "damaged2"},/area/ghostship)
"aB" = (/turf/simulated/floor/plating,/area/ghostship)
"aC" = (/obj/item/ammo_casing/a12mm,/turf/simulated/floor/plating,/area/ghostship)
"aD" = (/obj/item/stack/sheet/metal,/turf/simulated/floor/plating,/area/ghostship)
"aE" = (/obj/structure/grille{destroyed = 1},/obj/item/weapon/shard{icon_state = "small"},/obj/item/stack/rods,/turf/simulated/floor/plating/airless,/area/ghostship)
"aF" = (/obj/item/weapon/shard,/turf/simulated/floor/plating/ironsand/junkyard,/area/awaymission/junkyard/structure)
"aG" = (/turf/simulated/shuttle/wall{icon_state = "swall7"},/area/ghostship)
"aH" = (/turf/simulated/floor/plating/ironsand/junkyard,/turf/simulated/shuttle/wall{icon_state = "swall_s9"},/area/ghostship)
"aI" = (/obj/structure/sign/nanotrasen,/turf/simulated/shuttle/wall{icon_state = "swall12"},/area/ghostship)
"aJ" = (/obj/item/stack/sheet/plasteel,/turf/simulated/floor/plating/ironsand/junkyard,/area/awaymission/junkyard/structure)
"aK" = (/turf/simulated/shuttle/wall{icon_state = "swall15"},/area/derelict/ship)
"aL" = (/turf/simulated/shuttle/wall{icon_state = "swall2"},/turf/simulated/floor/plating/ironsand/junkyard,/area/awaymission/junkyard/structure)
"aM" = (/turf/simulated/shuttle/wall{icon_state = "swall2"},/area/ghostship)
"aN" = (/turf/simulated/floor/plating,/obj/structure/stool/bed/chair/metal{dir = 4},/turf/simulated/floor/plating/ironsand/junkyard,/area/ghostship)
"aO" = (/turf/simulated/floor{icon_state = "damaged4"},/area/ghostship)
"aP" = (/obj/effect/landmark/corpse/syndicatesoldier,/obj/item/weapon/melee/energy/sword/red,/obj/effect/decal/cleanable/blood,/turf/simulated/floor/plating,/area/ghostship)
"aQ" = (/turf/simulated/floor/plating,/obj/item/ammo_casing/a12mm,/turf/simulated/floor/plating/ironsand/junkyard,/area/awaymission/junkyard/structure)
"aR" = (/obj/item/ammo_casing/a357,/obj/item/ammo_casing/a357,/obj/item/weapon/gun/projectile/revolver/mateba,/obj/effect/landmark/corpse/commander{mobname = "Dave Mitchell"; name = "Dave Mitchell"},/obj/effect/decal/cleanable/blood,/turf/simulated/floor/plating,/area/ghostship)
"aS" = (/obj/structure/table/reinforced,/turf/simulated/floor/plating,/area/ghostship)
"aT" = (/obj/effect/landmark/corpse/engineer/rig{corpseidjob = "Gunner"; mobname = "Salem Rodriguez"; name = "Salem Rodriguez"},/obj/effect/decal/cleanable/blood,/turf/simulated/floor/plating,/area/ghostship)
"aU" = (/turf/simulated/floor/plating,/turf/simulated/shuttle/wall{icon_state = "swall_s9"},/area/derelict/ship)
"aV" = (/turf/simulated/floor/plating,/turf/simulated/shuttle/wall{icon_state = "swall_s6"},/area/ghostship)
"aW" = (/obj/item/ammo_casing/a12mm,/obj/item/ammo_casing/a12mm,/obj/item/ammo_casing/a12mm{pixel_x = -4; pixel_y = 5},/turf/simulated/floor{icon_state = "damaged2"},/area/ghostship)
"aX" = (/obj/item/stack/sheet/metal,/obj/item/ammo_casing/a12mm,/turf/simulated/floor,/area/ghostship)
"aY" = (/turf/simulated/floor,/area/ghostship)
"aZ" = (/obj/item/stack/cable_coil,/turf/simulated/floor/plating/ironsand/junkyard,/area/awaymission/junkyard/structure)
"ba" = (/turf/simulated/shuttle/wall{icon_state = "swall7"},/area/derelict/ship)
"bb" = (/turf/simulated/floor{icon_state = "damaged5"},/area/ghostship)
"bc" = (/turf/simulated/shuttle/wall{icon_state = "swall15"},/area/ghostship)
"bd" = (/obj/item/stack/sheet/metal,/turf/simulated/floor{icon_state = "damaged2"},/area/ghostship)
"be" = (/turf/simulated/floor/plating,/turf/simulated/shuttle/wall{icon_state = "swall_f10"},/area/ghostship)
"bf" = (/obj/machinery/telecomms/relay,/obj/machinery/light_construct,/turf/simulated/floor/plating,/area/ghostship)
"bg" = (/obj/effect/landmark/corpse/bridgeofficer{mobname = "Hector Gregory"; name = "Hector Gregory"},/obj/item/ammo_casing/a12mm,/obj/item/ammo_casing/a12mm,/obj/effect/decal/cleanable/blood,/turf/simulated/floor/plating,/area/ghostship)
"bh" = (/obj/structure/stool/bed/chair/schair/wagon{dir = 4},/obj/item/device/flashlight/seclite,/turf/simulated/floor/plating,/area/ghostship)
"bi" = (/turf/simulated/floor/plating/ironsand/junkyard,/area/ghostship)
"bj" = (/obj/structure/lattice,/obj/item/stack/rods,/turf/simulated/floor/plating/ironsand/junkyard,/area/awaymission/junkyard/structure)
"bk" = (/obj/item/stack/rods,/turf/simulated/floor/plating/ironsand/junkyard,/area/awaymission/junkyard/structure)
"bl" = (/obj/machinery/light_construct{dir = 1},/turf/simulated/floor{icon_state = "damaged4"},/area/ghostship)
"bm" = (/turf/simulated/shuttle/wall{icon_state = "swall3"},/area/ghostship)
"bn" = (/turf/simulated/floor/plating/ironsand/junkyard,/turf/simulated/shuttle/wall{icon_state = "swall_f5"},/area/ghostship)
"bo" = (/turf/simulated/shuttle/wall{icon_state = "swall13"},/area/ghostship)
"bp" = (/turf/simulated/shuttle/wall{icon_state = "swall8"},/area/ghostship)
"bq" = (/obj/structure/scrap/vehicle,/turf/simulated/floor{icon_state = "damaged1"},/area/ghostship)
"br" = (/obj/structure/lattice,/obj/item/stack/sheet/metal,/turf/simulated/floor/plating/ironsand/junkyard,/area/awaymission/junkyard/structure)
"bs" = (/obj/structure/closet/toolcloset,/turf/simulated/floor{icon_state = "damaged1"},/area/ghostship)
"bt" = (/turf/simulated/floor/plating/airless,/area/ghostship)
"bu" = (/obj/item/ammo_casing/a12mm,/obj/machinery/door/unpowered/shuttle/officer,/turf/simulated/floor/plating,/area/ghostship)
"bv" = (/turf/simulated/shuttle/wall{icon_state = "swall4"},/area/ghostship)
"bw" = (/turf/simulated/floor/plating/ironsand/junkyard,/turf/simulated/shuttle/wall{icon_state = "swall_s10"},/area/derelict/ship)
"bx" = (/obj/structure/shuttle/engine/heater{dir = 8},/obj/structure/window/reinforced{dir = 4},/turf/simulated/floor{icon_state = "engine"},/area/ghostship)
"by" = (/obj/structure/table/reinforced,/turf/simulated/floor,/area/ghostship)
"bz" = (/turf/simulated/floor/plating,/turf/simulated/shuttle/wall{icon_state = "swall_f5"},/area/ghostship)
"bA" = (/turf/simulated/floor/plating/ironsand/junkyard,/turf/simulated/shuttle/wall{icon_state = "swall_f10"},/area/ghostship)
"bB" = (/obj/structure/scrap/vehicle,/turf/simulated/floor{icon_state = "damaged2"},/area/ghostship)
"bC" = (/obj/machinery/light_construct{dir = 8},/turf/simulated/floor{icon_state = "damaged1"},/area/ghostship)
"bD" = (/obj/structure/stool/bed/chair/metal{dir = 4},/turf/simulated/floor{icon_state = "damaged2"},/area/ghostship)
"bE" = (/obj/structure/lattice,/obj/item/stack/sheet/metal,/turf/simulated/floor/plating/ironsand/junkyard,/area/ghostship)
"bF" = (/obj/structure/closet/crate/secure/weapon,/obj/item/ammo_casing/caseless/rocket/emp,/turf/simulated/floor/plating,/area/ghostship)
"bG" = (/obj/item/ammo_casing/a12mm,/obj/structure/closet/crate/secure/weapon,/turf/simulated/floor/plating,/area/ghostship)
"bH" = (/obj/structure/closet/crate/secure/weapon,/obj/item/bluespace_crystal,/turf/simulated/floor/plating,/area/ghostship)
"bI" = (/turf/simulated/floor/plating,/turf/simulated/shuttle/wall{icon_state = "swall_s5"},/area/ghostship)
"bJ" = (/obj/structure/sign/warning/radiation,/turf/simulated/shuttle/wall{icon_state = "swall12"},/area/ghostship)
"bK" = (/obj/structure/sign/warning/nosmoking,/turf/simulated/shuttle/wall{icon_state = "swall12"},/area/ghostship)
"bL" = (/obj/structure/shuttle/engine/propulsion{dir = 4},/turf/simulated/floor/plating/ironsand/junkyard,/area/ghostship)
"bM" = (/obj/machinery/power/emitter,/turf/simulated/floor/plating/airless,/area/ghostship)
"bN" = (/obj/structure/stool/bed/chair/metal{dir = 4},/turf/simulated/floor/plating,/area/ghostship)
"bO" = (/obj/item/ammo_casing/a12mm{pixel_x = 4},/obj/item/ammo_casing/a12mm{pixel_x = -4; pixel_y = 5},/turf/simulated/floor/plating,/area/ghostship)
"bP" = (/obj/machinery/light_construct{dir = 8},/turf/simulated/floor/plating,/area/ghostship)
"bQ" = (/obj/item/ammo_casing/a12mm{pixel_x = 4},/obj/item/ammo_casing/a12mm{pixel_x = -4; pixel_y = 5},/obj/item/ammo_casing/a12mm{pixel_x = 2; pixel_y = -7},/turf/simulated/floor/plating,/area/ghostship)
"bR" = (/mob/living/simple_animal/hostile/syndicate/ranged/space,/turf/simulated/floor/plating,/area/ghostship)
"bS" = (/obj/machinery/light_construct{dir = 1},/turf/simulated/floor/plating,/area/ghostship)
"bT" = (/obj/item/stack/sheet/metal,/turf/simulated/floor/plating/ironsand/junkyard,/area/awaymission/junkyard/structure)
"bU" = (/obj/structure/scrap/vehicle,/turf/simulated/floor{icon_state = "damaged5"},/area/ghostship)
"bV" = (/obj/structure/lattice,/obj/item/stack/sheet/metal,/obj/structure/stool/bed/chair/metal{dir = 4},/turf/simulated/floor/plating/ironsand/junkyard,/area/ghostship)
"bW" = (/turf/simulated/shuttle/wall{icon_state = "swall1"},/area/ghostship)
"bX" = (/obj/structure/artilleryplaceholder{icon_state = "1"},/turf/simulated/floor/plating/airless,/area/ghostship)
"bY" = (/obj/structure/artilleryplaceholder{icon_state = "2"},/turf/simulated/floor/plating/airless,/area/ghostship)
"bZ" = (/turf/simulated/floor/plating,/obj/structure/closet/crate/miningcar,/obj/item/ammo_casing/caseless/rocket/emp,/turf/simulated/floor/plating/ironsand/junkyard,/area/awaymission/junkyard/structure)
"ca" = (/obj/structure/artilleryplaceholder{icon_state = "4"},/turf/simulated/floor/plating/airless,/area/ghostship)
"cb" = (/obj/structure/artilleryplaceholder{icon_state = "5"},/turf/simulated/floor/plating/airless,/area/ghostship)
"cc" = (/obj/structure/artilleryplaceholder{icon_state = "6"},/turf/simulated/floor/plating/airless,/area/ghostship)
"cd" = (/obj/structure/artilleryplaceholder{icon_state = "7"},/turf/simulated/floor/plating/airless,/area/ghostship)
"ce" = (/obj/structure/artilleryplaceholder{icon_state = "8"},/turf/simulated/floor/plating/airless,/area/ghostship)
"cf" = (/obj/structure/artilleryplaceholder{icon_state = "9"},/turf/simulated/floor/plating/airless,/area/ghostship)
"cg" = (/obj/structure/artilleryplaceholder{icon_state = "10"},/turf/simulated/floor/plating/airless,/area/ghostship)
"ch" = (/obj/structure/artilleryplaceholder{icon_state = "11"},/turf/simulated/floor/plating/airless,/area/ghostship)
"ci" = (/obj/structure/artilleryplaceholder{icon_state = "12"},/turf/simulated/floor/plating/airless,/area/ghostship)
"cj" = (/obj/machinery/power/smes/magical{desc = "A high-capacity superconducting magnetic energy storage (SMES) unit."; name = "power storage unit"},/turf/simulated/floor,/area/ghostship)
"ck" = (/obj/machinery/door/unpowered/shuttle/officer,/turf/simulated/floor{icon_state = "damaged5"},/area/ghostship)
"cl" = (/obj/structure/scrap/guns,/turf/simulated/floor{icon_state = "damaged4"},/area/ghostship)
"cm" = (/turf/simulated/floor/plating,/area/awaymission/junkyard/structure)
"cn" = (/obj/structure/artilleryplaceholder{icon_state = "13"},/turf/simulated/floor/plating/airless,/area/ghostship)
"co" = (/obj/structure/artilleryplaceholder{icon_state = "14"},/turf/simulated/floor/plating/airless,/area/ghostship)
"cp" = (/obj/structure/artilleryplaceholder{icon_state = "15"},/turf/simulated/floor/plating/airless,/area/ghostship)
"cq" = (/obj/structure/artilleryplaceholder{icon_state = "16"},/turf/simulated/floor/plating/airless,/area/ghostship)
"cr" = (/obj/structure/artilleryplaceholder{icon_state = "17"},/turf/simulated/floor/plating/airless,/area/ghostship)
"cs" = (/obj/structure/artilleryplaceholder{icon_state = "18"},/turf/simulated/floor/plating/airless,/area/ghostship)
"ct" = (/obj/structure/artilleryplaceholder{icon_state = "19"},/turf/simulated/floor/plating/airless,/area/ghostship)
"cu" = (/obj/structure/artilleryplaceholder{icon_state = "20"},/turf/simulated/floor/plating/airless,/area/ghostship)
"cv" = (/obj/structure/artilleryplaceholder{icon_state = "21"},/turf/simulated/floor/plating/airless,/area/ghostship)
"cw" = (/obj/structure/artilleryplaceholder{icon_state = "22"},/turf/simulated/floor/plating/airless,/area/ghostship)
"cx" = (/obj/structure/artilleryplaceholder{icon_state = "23"},/turf/simulated/floor/plating/airless,/area/ghostship)
"cy" = (/obj/structure/artilleryplaceholder{icon_state = "24"},/turf/simulated/floor/plating/airless,/area/ghostship)
"cz" = (/turf/simulated/floor{icon_state = "damaged5"},/turf/simulated/floor/plating/ironsand/junkyard,/area/awaymission/junkyard/structure)
"cA" = (/obj/structure/lattice,/obj/structure/scrap/vehicle,/turf/simulated/floor/plating/ironsand/junkyard,/area/ghostship)
"cB" = (/turf/simulated/shuttle/wall{icon_state = "swall7"},/turf/simulated/floor/plating/ironsand/junkyard,/area/awaymission/junkyard/structure)
"cC" = (/obj/item/stack/sheet/metal,/turf/simulated/floor{icon_state = "damaged1"},/area/ghostship)
"cD" = (/turf/simulated/shuttle/wall{icon_state = "swall14"},/turf/simulated/floor/plating/ironsand/junkyard,/area/awaymission/junkyard/structure)
"cF" = (/obj/item/stack/rods,/turf/simulated/floor{icon_state = "damaged2"},/area/ghostship)
"cG" = (/obj/structure/lattice,/turf/simulated/floor/plating/ironsand/junkyard,/area/ghostship)
"cH" = (/obj/structure/artilleryplaceholder/decorative{icon_state = "25"},/turf/simulated/floor/plating/airless,/area/ghostship)
"cI" = (/obj/structure/artilleryplaceholder/decorative{icon_state = "26"},/turf/simulated/floor/plating/airless,/area/ghostship)
"cJ" = (/obj/structure/artilleryplaceholder/decorative{icon_state = "27"},/obj/item/weapon/stock_parts/cell/bluespace,/turf/simulated/floor/plating/airless,/area/ghostship)
"cK" = (/obj/structure/computerframe{anchored = 1},/turf/simulated/floor{icon_state = "dark"},/area/ghostship)
"cL" = (/obj/structure/artilleryplaceholder/decorative{icon_state = "29"},/turf/simulated/floor/plating/airless,/area/ghostship)
"cM" = (/obj/structure/artilleryplaceholder/decorative{icon_state = "30"},/turf/simulated/floor/plating/airless,/area/ghostship)
"cN" = (/obj/structure/artilleryplaceholder/decorative{icon_state = "31"},/turf/simulated/floor/plating/airless,/area/ghostship)
"cO" = (/obj/structure/artilleryplaceholder/decorative{icon_state = "32"},/turf/simulated/floor/plating/airless,/area/ghostship)
"cP" = (/obj/structure/artilleryplaceholder/decorative{icon_state = "33"},/turf/simulated/floor/plating/airless,/area/ghostship)
"cQ" = (/obj/structure/artilleryplaceholder/decorative{icon_state = "34"},/turf/simulated/floor/plating/airless,/area/ghostship)
"cR" = (/obj/structure/artilleryplaceholder{icon_state = "35"},/turf/simulated/floor/plating/airless,/area/ghostship)
"cS" = (/obj/structure/closet/crate{icon_state = "crateopen"; opened = 1},/turf/simulated/floor/plating,/area/ghostship)
"cT" = (/obj/item/ammo_casing/a12mm{pixel_x = -4; pixel_y = 5},/turf/simulated/floor/plating,/area/ghostship)
"cW" = (/obj/machinery/light_construct,/turf/simulated/floor/plating,/area/ghostship)
"cX" = (/turf/simulated/floor{icon_state = "damaged3"},/area/ghostship)
"cY" = (/obj/effect/landmark/corpse/engineer{mobname = "Dmitry Petrov"; name = "Dmitry Petrov"},/obj/effect/decal/cleanable/blood,/turf/simulated/floor/plating,/area/awaymission/spacebattle/cruiser)
"cZ" = (/obj/structure/closet/crate/secure/weapon,/turf/simulated/floor/plating,/area/ghostship)
"da" = (/obj/machinery/computer/monitor,/turf/simulated/floor,/area/ghostship)
"db" = (/obj/machinery/light_construct{dir = 1},/turf/simulated/floor{icon_state = "damaged2"},/area/ghostship)
"dd" = (/obj/machinery/telecomms/server,/turf/simulated/floor/plating,/area/ghostship)
"df" = (/obj/structure/sign/warning/fire,/turf/simulated/shuttle/wall{icon_state = "swall4"},/area/ghostship)
"dg" = (/obj/machinery/door/unpowered/shuttle/officer,/turf/simulated/floor/plating,/area/ghostship)
"dh" = (/obj/structure/scrap/vehicle,/turf/simulated/floor{icon_state = "damaged4"},/area/ghostship)
"dj" = (/obj/structure/table/reinforced,/obj/machinery/kitchen_machine/microwave,/turf/simulated/floor/plating,/area/ghostship)
"dk" = (/obj/structure/table/reinforced,/obj/item/weapon/reagent_containers/food/snacks/donkpocket,/obj/machinery/light_construct{dir = 1},/turf/simulated/floor/plating,/area/ghostship)
"dl" = (/obj/effect/landmark/corpse/bridgeofficer{mobname = "John Price"; name = "John Price"},/obj/item/ammo_casing/a12mm,/obj/item/ammo_casing/a12mm,/obj/effect/decal/cleanable/blood,/turf/simulated/floor/plating,/area/ghostship)
"dm" = (/obj/effect/landmark/corpse/bridgeofficer{mobname = "Hector Gregory"; name = "Hector Gregory"},/obj/item/weapon/gun/projectile/shotgun/combat,/obj/item/ammo_casing/a12mm,/obj/item/ammo_casing/a12mm,/obj/effect/decal/cleanable/blood,/turf/simulated/floor/plating,/area/ghostship)
"dn" = (/obj/item/clothing/suit/space/globose/black,/turf/simulated/floor/plating,/area/ghostship)
"do" = (/obj/item/ammo_casing/a12mm{pixel_x = 4},/turf/simulated/floor/plating,/area/ghostship)
"dp" = (/obj/item/ammo_casing/a12mm{pixel_x = -4; pixel_y = 5},/obj/item/ammo_casing/a12mm,/obj/item/ammo_casing/a12mm{pixel_x = 4},/turf/simulated/floor/plating,/area/ghostship)
"dq" = (/obj/item/weapon/shield/energy,/turf/simulated/floor/plating,/area/ghostship)
"dr" = (/obj/item/clothing/head/helmet/space/globose/black,/turf/simulated/floor/plating,/area/ghostship)
"ds" = (/obj/effect/landmark/corpse/bridgeofficer{mobname = "Sergey Liam"; name = "Sergey Liam"},/obj/item/ammo_casing/a12mm,/obj/item/ammo_casing/a12mm,/obj/effect/decal/cleanable/blood,/turf/simulated/floor/plating,/area/ghostship)
"dt" = (/turf/simulated/floor/plating,/turf/simulated/shuttle/wall{icon_state = "swall_s10"},/area/ghostship)
"du" = (/obj/machinery/telecomms/hub,/obj/machinery/light_construct,/turf/simulated/floor/plating,/area/ghostship)
"dv" = (/obj/structure/sign/nanotrasen,/turf/simulated/shuttle/wall{icon_state = "swall8"},/area/ghostship)

(1,1,1) = {"
aaaaaaaaaaaaaaaaaaaaaaaaaaabacadaaaaaaaaaaaeaiajakalamanaoaaaaaaaaaa
aaapaqaraaaaaaaaaaaaaaaaasatauavaaaaaaaaaaaAaBaCaBaBaBaDaEaFaaaaaaaa
aaaGaHaraIaraaaaaaaJaaasaKaiafaBaMaaagaaavaOaPaBahaRaBaSaoaaaaaaaaaa
aaaraaaaaTaaaaaaaaaaasaKaUaBavaVataOaWaXaYaAaAaBafaBamanaoaaaaaaaaaa
araaaaaZaaaracaracarbaaUbbaBaVbcaibdaVacacaqbeaSbfbgbhanaoaaaaaaaaaa
biaaaJbjaaaaavbkblaaaibbavaVbcaiaCaCbmaaaabnboacacacbpaoaoaaaaaaaaaa
aaaaarbqbraaaaaMbsbtbbaraBaGbcbpbubvbcbwaaaaaaaaaaaaaaaaaaaaaaaaaaaa
bxbkbyaaaaaJaabcacaaaAaObbaGaibbaBaObzbcacacacacbAaaaaaaaaaaaaaaaaaa
aaaZaaaraaaAbBaaaraaaraaaaatbCbDbEaCaBbmbFbGbHaBbIbJbKacacacacacacac
bLbxaabyarbMaraaaaaZaabkararaabtavbNbObmbPbQbRaBafaBaBaBaBbSaBaBaBaB
aaaaaaaraabTarbkaabraabUavaabVaabkaAafbWaBaBbXbYawcacbcccdcecfcgchci
bLarbxcjaaaaaaaaararaObbarckbbarclaAaBaxaBaBcncocpcqcrcsctcucvcwcxcy
bLaycjavaacAaaaaaObbazcCaAaLaOaNcFaraBaMaBafcHbtcIcJcKcLcMcNcOcPcQcR
aaaaaaaaaaaYaGaBbtbbcGafcSbmafcTaQaBafbmbPaBbZaBaBaBaBaBaBcWaBcmcmaB
byarcXaabTcYaaarbracacacadataBaNbbaBaBbmcZbHbHaBaVbJbKacacacacacacac
daaaaaaabbcXaBbcaadbbbczddcBbPaBaBaBaVbcacacacacaHaaaaaaaaaaaaaaaaaa
dfaZaabTaaaaavbWaAavbbaAafaGbcbpdgbvbcaHaaaaaaaaaaaaaaaaaaaaaaaaaaaa
btapardhaabkaaacaraaaBaraBbzbcbeaBaBbmaaaaascDacacacbpaoaoaaaaaaaaaa
aaaGaaaaaaarbkaaaaaaaraBaBaBbzbcbeaBbzacacaeaidjdkaBamanaoaaaaaaaaaa
aaaraaaaaBbbaaaaaJararbcbeaBaBbzataBdlaBaBaBaBaBaBdmamanaoaaaaaaaaaa
aaaaaabnboaIaraabkaaaabnbcbednaBbWaBaBaBdoaBdpbRdqaBaBaSaoaaaaaaaaaa
aaaaaaaaaaaaaaaaaaaaaaaabnataBdrdgaBaBaBaBaBaBdsaBaBamanaoaaaaaaaaaa
aaaJaaaaaaaaaaaaaaaaaaaaaabnacacacacacacacaqdtaSduaBamanaoaaaaaaaaaa
aaaaaaaaaaaaaaaaaaaaaaaaaaaaaaaaaaaaaaaaaabnboacacacdvaoaoaaaaaaaaaa
"}
