//MAP CONVERTED BY dmm2tgm.py THIS HEADER COMMENT PREVENTS RECONVERSION, DO NOT REMOVE
"a" = (
/turf/environment/space,
/area/space)
"f" = (
/obj/random/cloth/helmet,
/turf/unsimulated/floor/fakealien,
/area/custom/arena)
"i" = (
/obj/item/weapon/grenade/syndieminibomb,
/turf/unsimulated/floor/fakealien,
/area/custom/arena)
"n" = (
/obj/item/weapon/reagent_containers/hypospray/autoinjector/combat,
/turf/unsimulated/floor/fakealien,
/area/custom/arena)
"o" = (
/obj/mecha/combat/marauder/mauler{
	operation_req_access = list()
	},
/turf/unsimulated/floor/fakealien,
/area/custom/arena)
"p" = (
/obj/random/cloth/helmet,
/turf/unsimulated/floor/fakealien/weednode,
/area/custom/arena)
"q" = (
/turf/unsimulated/wall/fakealien,
/area/custom/arena)
"r" = (
/obj/effect/landmark{
	name = "eorgwarp"
	},
/turf/unsimulated/floor/fakealien/weednode,
/area/custom/arena)
"s" = (
/obj/random/guns/set_special,
/turf/unsimulated/floor/fakealien/weednode,
/area/custom/arena)
"v" = (
/turf/unsimulated/floor/fakealien,
/area/custom/arena)
"x" = (
/obj/random/guns/projectile_handgun,
/turf/unsimulated/floor/fakealien,
/area/custom/arena)
"y" = (
/obj/random/guns/energy_weapon,
/turf/unsimulated/floor/fakealien,
/area/custom/arena)
"A" = (
/obj/random/cloth/armor,
/turf/unsimulated/floor/fakealien,
/area/custom/arena)
"C" = (
/turf/unsimulated/floor/fakealien/weednode,
/area/custom/arena)
"F" = (
/obj/random/guns/energy_weapon,
/turf/unsimulated/floor/fakealien/weednode,
/area/custom/arena)
"G" = (
/obj/structure/alien/air_plant,
/turf/unsimulated/floor/fakealien,
/area/custom/arena)
"H" = (
/obj/structure/alien{
	desc = "It looks like a weird egg";
	icon_state = "egg";
	name = "egg"
	},
/turf/unsimulated/floor/fakealien,
/area/custom/arena)
"J" = (
/obj/random/guns/projectile_handgun,
/turf/unsimulated/floor/fakealien/weednode,
/area/custom/arena)
"K" = (
/obj/structure/barricade/wooden,
/obj/structure/barricade/wooden,
/turf/unsimulated/floor/fakealien,
/area/custom/arena)
"L" = (
/obj/random/melee,
/turf/unsimulated/floor/fakealien,
/area/custom/arena)
"R" = (
/obj/effect/landmark{
	name = "eorgwarp"
	},
/turf/unsimulated/floor/fakealien,
/area/custom/arena)
"S" = (
/obj/random/cloth/armor,
/turf/unsimulated/floor/fakealien/weednode,
/area/custom/arena)
"U" = (
/turf/unsimulated/wall/fakealienmembrane,
/area/custom/arena)
"X" = (
/obj/mecha/combat/marauder/loaded{
	operation_req_access = list()
	},
/turf/unsimulated/floor/fakealien,
/area/custom/arena)
"Z" = (
/obj/random/guns/set_special,
/turf/unsimulated/floor/fakealien,
/area/custom/arena)

(1,1,1) = {"
q
q
q
q
q
q
q
a
a
q
q
q
q
q
q
q
a
a
q
q
q
q
q
q
q
"}
(2,1,1) = {"
q
A
v
x
C
v
q
q
q
q
v
A
R
y
H
q
q
q
q
i
v
f
v
x
q
"}
(3,1,1) = {"
q
C
r
v
G
v
v
C
s
v
v
x
v
f
v
q
A
v
U
C
G
v
r
v
q
"}
(4,1,1) = {"
q
F
f
q
U
q
v
v
C
C
C
q
q
U
v
q
y
R
q
v
v
y
C
S
q
"}
(5,1,1) = {"
q
C
v
q
x
v
f
v
q
v
S
v
q
v
v
C
J
p
v
Z
q
q
v
v
q
"}
(6,1,1) = {"
q
v
v
v
v
R
v
H
q
q
R
y
v
v
Z
C
v
v
q
A
v
x
v
v
q
"}
(7,1,1) = {"
q
q
q
v
v
A
y
v
U
v
f
x
q
q
q
v
q
q
q
v
R
v
q
q
q
"}
(8,1,1) = {"
a
q
v
Z
q
v
q
q
q
v
v
v
v
U
v
f
v
v
q
q
y
p
v
q
a
"}
(9,1,1) = {"
a
q
i
v
U
C
v
C
q
q
v
v
n
q
v
R
y
v
Z
v
v
C
C
q
a
"}
(10,1,1) = {"
q
q
v
q
q
C
C
x
C
C
Z
q
G
v
x
C
S
v
v
q
q
q
v
q
q
"}
(11,1,1) = {"
q
H
v
v
q
v
S
r
p
v
q
q
q
q
U
q
q
C
U
q
v
y
v
H
q
"}
(12,1,1) = {"
q
f
C
F
q
v
C
F
v
v
L
q
X
q
L
A
v
x
v
q
f
R
A
v
q
"}
(13,1,1) = {"
q
v
r
v
v
v
v
q
q
G
v
K
n
K
v
v
R
v
v
q
v
J
v
q
q
"}
(14,1,1) = {"
q
x
C
A
q
q
U
q
v
C
L
q
o
q
L
v
y
f
v
Z
v
C
C
v
q
"}
(15,1,1) = {"
q
v
v
v
v
q
H
A
y
C
q
q
q
q
q
v
q
q
U
q
v
v
s
G
q
"}
(16,1,1) = {"
q
q
q
q
v
v
Z
v
r
p
v
q
v
n
v
s
v
v
v
q
U
q
v
q
q
"}
(17,1,1) = {"
a
q
v
x
C
A
q
v
v
J
v
Z
C
U
v
C
p
F
v
v
v
x
f
q
a
"}
(18,1,1) = {"
a
q
v
v
R
y
q
U
q
v
v
v
v
q
q
q
v
R
A
q
A
R
v
q
a
"}
(19,1,1) = {"
q
q
v
f
v
q
q
v
v
C
q
v
q
q
v
v
x
v
H
q
v
y
q
q
q
"}
(20,1,1) = {"
q
H
Z
q
v
v
q
f
C
v
U
v
v
A
v
v
q
q
q
q
v
v
v
v
q
"}
(21,1,1) = {"
q
v
C
q
q
G
v
r
F
q
q
q
C
C
r
y
v
q
i
v
v
q
q
C
q
"}
(22,1,1) = {"
q
v
S
v
q
v
x
C
A
v
v
Z
C
x
f
G
v
U
v
C
v
y
v
C
q
"}
(23,1,1) = {"
q
y
r
C
v
Z
q
v
v
q
v
v
v
U
v
C
v
Z
v
v
f
r
S
v
q
"}
(24,1,1) = {"
q
x
v
p
C
v
q
q
q
q
i
v
H
q
v
q
q
q
q
v
v
J
v
H
q
"}
(25,1,1) = {"
q
q
q
q
q
q
q
a
a
q
q
q
q
q
q
q
a
a
q
q
q
q
q
q
q
"}
