"a" = (/turf/simulated/floor/holofloor{icon_state = "dark"},/area/holodeck/source_basketball)
"b" = (/obj/structure/holostool,/turf/simulated/floor/holofloor{dir = 5; icon_state = "vault"},/area/holodeck/source_basketball)
"c" = (/obj/structure/window/reinforced/holowindow{dir = 4},/obj/structure/holostool,/turf/simulated/floor/holofloor{dir = 5; icon_state = "vault"},/area/holodeck/source_basketball)
"d" = (/turf/simulated/floor/holofloor{dir = 9; icon_state = "red"},/area/holodeck/source_basketball)
"e" = (/turf/simulated/floor/holofloor{dir = 1; icon_state = "red"},/area/holodeck/source_basketball)
"f" = (/obj/structure/holohoop,/turf/simulated/floor/holofloor{dir = 1; icon_state = "red"},/area/holodeck/source_basketball)
"g" = (/turf/simulated/floor/holofloor{dir = 5; icon_state = "red"},/area/holodeck/source_basketball)
"h" = (/turf/simulated/floor/holofloor{dir = 8; icon_state = "red"},/area/holodeck/source_basketball)
"i" = (/turf/simulated/floor/holofloor,/area/holodeck/source_basketball)
"j" = (/turf/simulated/floor/holofloor{dir = 4; icon_state = "red"},/area/holodeck/source_basketball)
"k" = (/obj/machinery/door/window/holowindoor{dir = 4; name = "Red Team"},/turf/simulated/floor/holofloor{icon_state = "dark"},/area/holodeck/source_basketball)
"l" = (/turf/simulated/floor/holofloor{dir = 10; icon_state = "red"},/area/holodeck/source_basketball)
"m" = (/turf/simulated/floor/holofloor{dir = 2; icon_state = "red"},/area/holodeck/source_basketball)
"n" = (/obj/item/weapon/beach_ball/holoball,/turf/simulated/floor/holofloor{dir = 2; icon_state = "red"},/area/holodeck/source_basketball)
"o" = (/turf/simulated/floor/holofloor{dir = 6; icon_state = "red"},/area/holodeck/source_basketball)
"p" = (/turf/simulated/floor/holofloor{dir = 9; icon_state = "green"},/area/holodeck/source_basketball)
"q" = (/turf/simulated/floor/holofloor{dir = 1; icon_state = "green"},/area/holodeck/source_basketball)
"r" = (/turf/simulated/floor/holofloor{dir = 5; icon_state = "green"},/area/holodeck/source_basketball)
"s" = (/turf/simulated/floor/holofloor{dir = 8; icon_state = "green"},/area/holodeck/source_basketball)
"t" = (/turf/simulated/floor/holofloor{dir = 4; icon_state = "green"},/area/holodeck/source_basketball)
"u" = (/obj/machinery/door/window/holowindoor{base_state = "right"; dir = 4; icon_state = "right"; name = "Green Team"},/turf/simulated/floor/holofloor{icon_state = "dark"},/area/holodeck/source_basketball)
"v" = (/turf/simulated/floor/holofloor{dir = 2; icon_state = "green"},/area/holodeck/source_basketball)
"w" = (/turf/simulated/floor/holofloor{dir = 10; icon_state = "green"},/area/holodeck/source_basketball)
"x" = (/obj/structure/holohoop{dir = 1},/turf/simulated/floor/holofloor{dir = 2; icon_state = "green"},/area/holodeck/source_basketball)
"y" = (/turf/simulated/floor/holofloor{dir = 6; icon_state = "green"},/area/holodeck/source_basketball)

(1,1,1) = {"
abcdedfgeg
abchihijij
aakhieeeij
abchiiiiij
abclmmnmmo
abcpqqqqqr
abcsiiiiit
aausivvvit
abcsisitit
abcwvwxyvy
"}
