//MAP CONVERTED BY dmm2tgm.py THIS HEADER COMMENT PREVENTS RECONVERSION, DO NOT REMOVE
"a" = (
/turf/simulated/floor/beach/sand{
	dir = 9;
	icon_state = "beach"
	},
/area/station/civilian/holodeck/source_beach)
"b" = (
/turf/simulated/floor/beach/sand{
	dir = 1;
	icon_state = "beach"
	},
/area/station/civilian/holodeck/source_beach)
"c" = (
/turf/simulated/floor/beach/sand{
	dir = 5;
	icon_state = "beach"
	},
/area/station/civilian/holodeck/source_beach)
"d" = (
/turf/simulated/floor/beach/sand{
	dir = 8;
	icon_state = "beach"
	},
/area/station/civilian/holodeck/source_beach)
"e" = (
/turf/simulated/floor/beach/sand{
	icon_state = "desert0"
	},
/area/station/civilian/holodeck/source_beach)
"f" = (
/turf/simulated/floor/beach/sand{
	dir = 8;
	icon_state = "beachcorner"
	},
/area/station/civilian/holodeck/source_beach)
"g" = (
/turf/simulated/floor/beach/sand{
	dir = 4;
	icon_state = "beachcorner"
	},
/area/station/civilian/holodeck/source_beach)
"h" = (
/turf/simulated/floor/beach/sand{
	icon_state = "desert3"
	},
/area/station/civilian/holodeck/source_beach)
"i" = (
/turf/simulated/floor/beach/sand{
	icon_state = "desert"
	},
/area/station/civilian/holodeck/source_beach)
"j" = (
/turf/simulated/floor/beach/sand{
	icon_state = "desert1"
	},
/area/station/civilian/holodeck/source_beach)
"k" = (
/obj/item/weapon/inflatable_duck,
/turf/simulated/floor/beach/sand{
	icon_state = "desert0"
	},
/area/station/civilian/holodeck/source_beach)
"l" = (
/obj/item/clothing/glasses/sunglasses,
/turf/simulated/floor/beach/sand{
	icon_state = "desert0"
	},
/area/station/civilian/holodeck/source_beach)
"m" = (
/obj/effect/overlay/palmtree_l,
/obj/effect/overlay/coconut,
/turf/simulated/floor/beach/sand{
	icon_state = "desert0"
	},
/area/station/civilian/holodeck/source_beach)
"n" = (
/obj/effect/overlay/palmtree_r,
/turf/simulated/floor/beach/sand{
	icon_state = "desert"
	},
/area/station/civilian/holodeck/source_beach)
"o" = (
/turf/simulated/floor/beach/sand{
	icon_state = "seashallow"
	},
/area/station/civilian/holodeck/source_beach)
"p" = (
/obj/item/weapon/beach_ball,
/turf/simulated/floor/beach/sand{
	icon_state = "desert"
	},
/area/station/civilian/holodeck/source_beach)
"q" = (
/turf/simulated/floor/beach/sand{
	icon_state = "desert4"
	},
/area/station/civilian/holodeck/source_beach)

(1,1,1) = {"
o
o
o
c
f
i
e
i
j
i
"}
(2,1,1) = {"
o
o
o
o
b
j
h
e
i
q
"}
(3,1,1) = {"
o
o
o
o
b
i
e
n
h
j
"}
(4,1,1) = {"
o
o
o
a
g
e
i
i
p
q
"}
(5,1,1) = {"
o
o
o
b
h
i
h
j
h
e
"}
(6,1,1) = {"
o
o
o
b
i
k
i
i
e
e
"}
(7,1,1) = {"
o
o
o
c
f
e
i
j
i
e
"}
(8,1,1) = {"
o
o
o
o
b
i
l
i
q
e
"}
(9,1,1) = {"
o
o
a
d
g
h
m
e
j
e
"}
(10,1,1) = {"
o
o
b
e
h
e
i
e
e
e
"}
