//MAP CONVERTED BY dmm2tgm.py THIS HEADER COMMENT PREVENTS RECONVERSION, DO NOT REMOVE
"a" = (
/obj/structure/table/holotable,
/obj/item/clothing/gloves/boxing/hologlove,
/turf/simulated/floor/holofloor{
	icon_state = "wooden-2"
	},
/area/station/civilian/holodeck/source_boxingcourt)
"b" = (
/turf/simulated/floor/holofloor{
	icon_state = "wooden-2"
	},
/area/station/civilian/holodeck/source_boxingcourt)
"c" = (
/obj/structure/stool/bed/chair/holochair,
/turf/simulated/floor/holofloor{
	icon_state = "wooden-2"
	},
/area/station/civilian/holodeck/source_boxingcourt)
"d" = (
/obj/machinery/door/window/holowindoor{
	base_state = "right";
	icon_state = "right";
	name = "Red Corner"
	},
/turf/simulated/floor/holofloor{
	icon_state = "wooden-2"
	},
/area/station/civilian/holodeck/source_boxingcourt)
"e" = (
/obj/structure/window/reinforced/holowindow,
/turf/simulated/floor/holofloor{
	icon_state = "wooden-2"
	},
/area/station/civilian/holodeck/source_boxingcourt)
"f" = (
/obj/structure/stool/bed/chair/holochair{
	dir = 4
	},
/turf/simulated/floor/holofloor{
	icon_state = "wooden-2"
	},
/area/station/civilian/holodeck/source_boxingcourt)
"g" = (
/obj/structure/window/reinforced/holowindow{
	dir = 4
	},
/turf/simulated/floor/holofloor{
	icon_state = "wooden-2"
	},
/area/station/civilian/holodeck/source_boxingcourt)
"h" = (
/obj/structure/holostool,
/turf/simulated/floor/holofloor{
	icon_state = "boxing"
	},
/area/station/civilian/holodeck/source_boxingcourt)
"i" = (
/turf/simulated/floor/holofloor{
	icon_state = "boxing"
	},
/area/station/civilian/holodeck/source_boxingcourt)
"j" = (
/obj/structure/window/reinforced/holowindow{
	dir = 8
	},
/turf/simulated/floor/holofloor{
	icon_state = "wooden-2"
	},
/area/station/civilian/holodeck/source_boxingcourt)
"k" = (
/obj/structure/stool/bed/chair/holochair{
	dir = 8
	},
/turf/simulated/floor/holofloor{
	icon_state = "wooden-2"
	},
/area/station/civilian/holodeck/source_boxingcourt)
"l" = (
/obj/structure/stool/bed/chair/holochair{
	dir = 1
	},
/turf/simulated/floor/holofloor{
	icon_state = "wooden-2"
	},
/area/station/civilian/holodeck/source_boxingcourt)
"p" = (
/obj/structure/window/reinforced/holowindow{
	dir = 1
	},
/turf/simulated/floor/holofloor{
	icon_state = "wooden-2"
	},
/area/station/civilian/holodeck/source_boxingcourt)
"q" = (
/obj/machinery/door/window/holowindoor{
	dir = 1;
	name = "Green Corner"
	},
/turf/simulated/floor/holofloor{
	icon_state = "wooden-2"
	},
/area/station/civilian/holodeck/source_boxingcourt)
"r" = (
/obj/structure/table/holotable,
/obj/item/clothing/gloves/boxing/hologlove{
	icon_state = "boxinggreen";
	item_state = "boxinggreen"
	},
/turf/simulated/floor/holofloor{
	icon_state = "wooden-2"
	},
/area/station/civilian/holodeck/source_boxingcourt)

(1,1,1) = {"
a
b
b
b
b
b
b
b
b
b
"}
(2,1,1) = {"
a
b
b
f
f
f
f
b
b
b
"}
(3,1,1) = {"
b
b
b
g
g
g
g
b
b
b
"}
(4,1,1) = {"
b
c
d
h
i
i
i
p
l
b
"}
(5,1,1) = {"
b
c
e
i
i
i
i
p
l
b
"}
(6,1,1) = {"
b
c
e
i
i
i
i
p
l
b
"}
(7,1,1) = {"
b
c
e
i
i
i
h
q
l
b
"}
(8,1,1) = {"
b
b
b
j
j
j
j
b
b
b
"}
(9,1,1) = {"
b
b
b
k
k
k
k
b
b
r
"}
(10,1,1) = {"
b
b
b
b
b
b
b
b
b
r
"}
