"a" = (/obj/structure/table/holotable,/obj/item/clothing/gloves/boxing/hologlove,/turf/simulated/floor/holofloor{icon_state = "dark"},/area/holodeck/source_boxingcourt)
"b" = (/turf/simulated/floor/holofloor{icon_state = "dark"},/area/holodeck/source_boxingcourt)
"c" = (/obj/structure/holostool,/turf/simulated/floor/holofloor{icon_state = "dark"},/area/holodeck/source_boxingcourt)
"d" = (/obj/machinery/door/window/holowindoor{base_state = "right"; dir = 2; icon_state = "right"; name = "Red Corner"},/turf/simulated/floor/holofloor{icon_state = "dark"},/area/holodeck/source_boxingcourt)
"e" = (/obj/structure/window/reinforced/holowindow,/turf/simulated/floor/holofloor{icon_state = "dark"},/area/holodeck/source_boxingcourt)
"f" = (/obj/structure/window/reinforced/holowindow{dir = 4},/turf/simulated/floor/holofloor{icon_state = "dark"},/area/holodeck/source_boxingcourt)
"g" = (/turf/simulated/floor/holofloor{dir = 9; icon_state = "red"},/area/holodeck/source_boxingcourt)
"h" = (/turf/simulated/floor/holofloor{dir = 1; icon_state = "red"},/area/holodeck/source_boxingcourt)
"i" = (/turf/simulated/floor/holofloor,/area/holodeck/source_boxingcourt)
"j" = (/obj/structure/window/reinforced/holowindow{dir = 8},/turf/simulated/floor/holofloor{icon_state = "dark"},/area/holodeck/source_boxingcourt)
"k" = (/turf/simulated/floor/holofloor{dir = 8; icon_state = "red"},/area/holodeck/source_boxingcourt)
"l" = (/turf/simulated/floor/holofloor{icon_state = "bluefull"},/area/holodeck/source_boxingcourt)
"m" = (/turf/simulated/floor/holofloor{dir = 4; icon_state = "green"},/area/holodeck/source_boxingcourt)
"n" = (/turf/simulated/floor/holofloor{dir = 2; icon_state = "green"},/area/holodeck/source_boxingcourt)
"o" = (/turf/simulated/floor/holofloor{dir = 6; icon_state = "green"},/area/holodeck/source_boxingcourt)
"p" = (/obj/structure/window/reinforced/holowindow{dir = 1},/turf/simulated/floor/holofloor{icon_state = "dark"},/area/holodeck/source_boxingcourt)
"q" = (/obj/machinery/door/window/holowindoor{dir = 1; name = "Green Corner"},/turf/simulated/floor/holofloor{icon_state = "dark"},/area/holodeck/source_boxingcourt)
"r" = (/obj/structure/table/holotable,/obj/item/clothing/gloves/boxing/hologlove{icon_state = "boxinggreen"; item_state = "boxinggreen"},/turf/simulated/floor/holofloor{icon_state = "dark"},/area/holodeck/source_boxingcourt)

(1,1,1) = {"
aabbbbbbbb
bbbbcccbbb
bbbdeeebbb
bcfghhijcb
bcfkllmjcb
bcfkllmjcb
bcfinnojcb
bbbpppqbbb
bbbcccbbbb
bbbbbbbbrr
"}
