//MAP CONVERTED BY dmm2tgm.py THIS HEADER COMMENT PREVENTS RECONVERSION, DO NOT REMOVE
"a" = (
/turf/simulated/floor/holofloor{
	icon_state = "grimy"
	},
/area/station/civilian/holodeck/source_courtroom)
"b" = (
/obj/structure/stool/bed/chair/holochair,
/turf/simulated/floor/holofloor/carpet,
/area/station/civilian/holodeck/source_courtroom)
"c" = (
/obj/structure/table/holotable/wooden,
/turf/simulated/floor/holofloor{
	icon_state = "dark"
	},
/area/station/civilian/holodeck/source_courtroom)
"d" = (
/obj/structure/table/holotable/wooden,
/obj/structure/window/thin/reinforced/holowindow,
/obj/structure/window/thin/reinforced/holowindow{
	dir = 8
	},
/turf/simulated/floor/holofloor/carpet,
/area/station/civilian/holodeck/source_courtroom)
"e" = (
/turf/simulated/floor/holofloor{
	icon_state = "dark"
	},
/area/station/civilian/holodeck/source_courtroom)
"f" = (
/obj/structure/table/holotable/wooden,
/obj/structure/window/thin/reinforced/holowindow{
	dir = 8
	},
/turf/simulated/floor/holofloor/carpet,
/area/station/civilian/holodeck/source_courtroom)
"h" = (
/obj/structure/table/holotable/wooden,
/obj/structure/window/thin/reinforced/holowindow{
	dir = 4
	},
/turf/simulated/floor/holofloor{
	icon_state = "dark"
	},
/area/station/civilian/holodeck/source_courtroom)
"i" = (
/obj/structure/table/holotable/wooden,
/obj/structure/window/thin/reinforced/holowindow,
/turf/simulated/floor/holofloor/carpet,
/area/station/civilian/holodeck/source_courtroom)
"k" = (
/obj/structure/stool/bed/chair/holochair{
	dir = 4;
	icon_state = "chair"
	},
/obj/machinery/door/window/holowindoor{
	dir = 8;
	icon_state = "right"
	},
/obj/structure/window/thin/reinforced/holowindow{
	dir = 4
	},
/obj/structure/window/thin/reinforced/holowindow,
/turf/simulated/floor/holofloor{
	icon_state = "dark"
	},
/area/station/civilian/holodeck/source_courtroom)
"m" = (
/obj/structure/stool/bed/chair/holochair{
	dir = 8
	},
/turf/simulated/floor/holofloor/carpet,
/area/station/civilian/holodeck/source_courtroom)
"q" = (
/turf/simulated/floor/holofloor/carpet,
/area/station/civilian/holodeck/source_courtroom)
"t" = (
/obj/structure/stool/bed/chair/holochair{
	dir = 4;
	icon_state = "comfychair"
	},
/turf/simulated/floor/holofloor{
	icon_state = "dark"
	},
/area/station/civilian/holodeck/source_courtroom)
"x" = (
/obj/structure/stool/bed/chair/holochair{
	dir = 4;
	icon_state = "chair"
	},
/obj/machinery/door/window/holowindoor{
	dir = 8
	},
/obj/structure/window/thin/reinforced/holowindow{
	dir = 4
	},
/obj/structure/window/thin/reinforced/holowindow{
	dir = 1
	},
/turf/simulated/floor/holofloor{
	icon_state = "dark"
	},
/area/station/civilian/holodeck/source_courtroom)
"D" = (
/obj/item/weapon/flora/pottedplant{
	icon_state = "plant-10"
	},
/obj/structure/window/thin/reinforced/holowindow{
	dir = 1
	},
/turf/simulated/floor/holofloor{
	icon_state = "grimy"
	},
/area/station/civilian/holodeck/source_courtroom)
"E" = (
/obj/machinery/door/window/holowindoor{
	dir = 1;
	name = "Door"
	},
/turf/simulated/floor/holofloor{
	icon_state = "grimy"
	},
/area/station/civilian/holodeck/source_courtroom)
"F" = (
/obj/structure/window/thin/reinforced/holowindow{
	dir = 1
	},
/turf/simulated/floor/holofloor{
	icon_state = "grimy"
	},
/area/station/civilian/holodeck/source_courtroom)
"G" = (
/obj/structure/table/holotable/wooden,
/turf/simulated/floor/holofloor/carpet,
/area/station/civilian/holodeck/source_courtroom)
"H" = (
/obj/machinery/door/window/holowindoor{
	dir = 1;
	name = "Jury Box"
	},
/turf/simulated/floor/holofloor{
	icon_state = "grimy"
	},
/area/station/civilian/holodeck/source_courtroom)

(1,1,1) = {"
c
c
c
c
c
c
c
c
D
a
"}
(2,1,1) = {"
e
e
e
e
e
e
e
e
E
a
"}
(3,1,1) = {"
q
f
d
e
c
t
c
e
F
a
"}
(4,1,1) = {"
b
b
i
k
h
h
h
x
F
a
"}
(5,1,1) = {"
b
b
i
q
q
q
q
q
F
a
"}
(6,1,1) = {"
b
b
i
G
G
q
G
G
F
a
"}
(7,1,1) = {"
b
b
i
m
m
q
m
m
F
a
"}
(8,1,1) = {"
b
b
i
q
q
q
q
q
F
a
"}
(9,1,1) = {"
b
b
i
m
m
m
m
m
H
a
"}
(10,1,1) = {"
G
G
i
m
m
m
m
m
D
a
"}
