//MAP CONVERTED BY dmm2tgm.py THIS HEADER COMMENT PREVENTS RECONVERSION, DO NOT REMOVE
"a" = (
/turf/simulated/floor/holofloor{
	icon_state = "grimy"
	},
/area/station/civilian/holodeck/source_courtroom)
"b" = (
/obj/structure/stool/bed/chair/holochair{
	icon_state = "chair"
	},
/obj/structure/window/reinforced/holowindow{
	dir = 8
	},
/turf/simulated/floor/holofloor{
	icon_state = "dark"
	},
/area/station/civilian/holodeck/source_courtroom)
"c" = (
/obj/structure/stool/bed/chair/holochair{
	icon_state = "chair"
	},
/turf/simulated/floor/holofloor{
	icon_state = "dark"
	},
/area/station/civilian/holodeck/source_courtroom)
"d" = (
/turf/simulated/floor/holofloor{
	dir = 6;
	icon_state = "wood_stairs2"
	},
/area/station/civilian/holodeck/source_courtroom)
"e" = (
/obj/structure/stool/bed/chair/holochair{
	icon_state = "chair"
	},
/obj/structure/window/reinforced/holowindow{
	dir = 4
	},
/turf/simulated/floor/holofloor{
	icon_state = "dark"
	},
/area/station/civilian/holodeck/source_courtroom)
"f" = (
/turf/simulated/floor/holofloor{
	icon_state = "wooden"
	},
/area/station/civilian/holodeck/source_courtroom)
"g" = (
/obj/structure/window/reinforced/holowindow,
/obj/machinery/door/window/holowindoor{
	dir = 8;
	icon_state = "right"
	},
/turf/simulated/floor/holofloor{
	icon_state = "dark"
	},
/area/station/civilian/holodeck/source_courtroom)
"h" = (
/obj/structure/stool/bed/chair/holochair{
	dir = 4
	},
/turf/simulated/floor/holofloor{
	icon_state = "grimy"
	},
/area/station/civilian/holodeck/source_courtroom)
"i" = (
/obj/structure/stool/bed/chair/holochair{
	color = "#ff7100";
	icon_state = "comfychair"
	},
/turf/simulated/floor/holofloor{
	icon_state = "wooden"
	},
/area/station/civilian/holodeck/source_courtroom)
"j" = (
/obj/structure/stool/bed/chair/holochair{
	dir = 1
	},
/turf/simulated/floor/holofloor{
	dir = 4;
	icon_state = "carpet15-15"
	},
/area/station/civilian/holodeck/source_courtroom)
"k" = (
/obj/structure/table/holotable/wooden,
/obj/structure/window/reinforced/holowindow,
/turf/simulated/floor/holofloor{
	icon_state = "wooden"
	},
/area/station/civilian/holodeck/source_courtroom)
"l" = (
/turf/simulated/floor/holofloor{
	dir = 4;
	icon_state = "carpet11-12"
	},
/area/station/civilian/holodeck/source_courtroom)
"m" = (
/turf/simulated/floor/holofloor{
	dir = 4;
	icon_state = "carpet9-4"
	},
/area/station/civilian/holodeck/source_courtroom)
"p" = (
/obj/structure/stool/bed/chair/holochair{
	dir = 8
	},
/turf/simulated/floor/holofloor{
	icon_state = "grimy"
	},
/area/station/civilian/holodeck/source_courtroom)
"q" = (
/turf/simulated/floor/holofloor{
	dir = 4;
	icon_state = "carpet6-2"
	},
/area/station/civilian/holodeck/source_courtroom)
"r" = (
/turf/simulated/floor/holofloor{
	dir = 4;
	icon_state = "carpet14-10"
	},
/area/station/civilian/holodeck/source_courtroom)
"u" = (
/obj/structure/stool/bed/chair/holochair{
	dir = 8
	},
/turf/simulated/floor/holofloor{
	icon_state = "wooden"
	},
/area/station/civilian/holodeck/source_courtroom)
"v" = (
/turf/simulated/floor/holofloor{
	dir = 4;
	icon_state = "carpet10-8"
	},
/area/station/civilian/holodeck/source_courtroom)
"y" = (
/turf/simulated/floor/holofloor{
	dir = 4;
	icon_state = "carpet5-1"
	},
/area/station/civilian/holodeck/source_courtroom)
"A" = (
/turf/simulated/floor/holofloor{
	dir = 4;
	icon_state = "carpet7-3"
	},
/area/station/civilian/holodeck/source_courtroom)
"B" = (
/turf/simulated/floor/holofloor{
	dir = 4;
	icon_state = "carpet13-5"
	},
/area/station/civilian/holodeck/source_courtroom)
"C" = (
/obj/structure/stool/bed/chair/holochair,
/turf/simulated/floor/holofloor{
	icon_state = "wooden"
	},
/area/station/civilian/holodeck/source_courtroom)
"D" = (
/obj/structure/window/reinforced/holowindow,
/turf/simulated/floor/holofloor{
	icon_state = "dark"
	},
/area/station/civilian/holodeck/source_courtroom)
"E" = (
/obj/structure/window/reinforced/holowindow,
/obj/machinery/door/window/holowindoor{
	dir = 4;
	icon_state = "right"
	},
/turf/simulated/floor/holofloor{
	icon_state = "dark"
	},
/area/station/civilian/holodeck/source_courtroom)
"F" = (
/obj/structure/stool/bed/chair/holochair{
	dir = 4
	},
/turf/simulated/floor/holofloor{
	icon_state = "wooden"
	},
/area/station/civilian/holodeck/source_courtroom)
"G" = (
/obj/structure/window/reinforced/holowindow,
/obj/structure/table/holotable/wooden,
/turf/simulated/floor/holofloor{
	icon_state = "wooden"
	},
/area/station/civilian/holodeck/source_courtroom)
"H" = (
/turf/simulated/floor/holofloor{
	icon_state = "wood_stairs2"
	},
/area/station/civilian/holodeck/source_courtroom)

(1,1,1) = {"
c
D
F
G
a
h
h
h
h
a
"}
(2,1,1) = {"
e
E
f
H
a
a
a
a
a
a
"}
(3,1,1) = {"
C
f
f
d
q
A
A
A
A
y
"}
(4,1,1) = {"
C
f
i
k
r
j
j
j
j
B
"}
(5,1,1) = {"
C
f
i
k
r
j
j
j
j
B
"}
(6,1,1) = {"
C
f
i
k
r
j
j
j
j
B
"}
(7,1,1) = {"
C
f
i
k
r
j
j
j
j
B
"}
(8,1,1) = {"
C
f
f
H
v
l
l
l
l
m
"}
(9,1,1) = {"
b
g
f
d
a
a
a
a
a
a
"}
(10,1,1) = {"
c
D
u
G
a
p
p
p
p
a
"}
