//MAP CONVERTED BY dmm2tgm.py THIS HEADER COMMENT PREVENTS RECONVERSION, DO NOT REMOVE
"a" = (
/turf/simulated/floor/holofloor{
	icon_state = "wooden"
	},
/area/station/civilian/holodeck/source_meetinghall)
"b" = (
/obj/item/weapon/flora/pottedplant{
	icon_state = "plant-6"
	},
/turf/simulated/floor/holofloor{
	icon_state = "wooden"
	},
/area/station/civilian/holodeck/source_meetinghall)
"c" = (
/turf/simulated/floor/holofloor/carpet,
/area/station/civilian/holodeck/source_meetinghall)
"f" = (
/obj/effect/decal/turf_decal/metal{
	dir = 1;
	icon_state = "spline_plain"
	},
/turf/simulated/floor/holofloor{
	icon_state = "grimy"
	},
/area/station/civilian/holodeck/source_meetinghall)
"g" = (
/turf/simulated/floor/holofloor{
	icon_state = "wood_stairs2"
	},
/area/station/civilian/holodeck/source_meetinghall)
"k" = (
/turf/simulated/floor/holofloor{
	icon_state = "grimy"
	},
/area/station/civilian/holodeck/source_meetinghall)
"p" = (
/obj/structure/holostool,
/turf/simulated/floor/holofloor/carpet,
/area/station/civilian/holodeck/source_meetinghall)

(1,1,1) = {"
a
a
a
f
k
k
k
k
k
k
"}
(2,1,1) = {"
a
a
a
f
p
p
p
p
p
k
"}
(3,1,1) = {"
a
c
a
f
p
p
p
p
p
c
"}
(4,1,1) = {"
a
c
a
f
p
p
p
p
p
k
"}
(5,1,1) = {"
a
c
a
f
p
p
p
p
p
k
"}
(6,1,1) = {"
a
c
a
f
p
p
p
p
p
k
"}
(7,1,1) = {"
a
c
a
f
p
p
p
p
p
k
"}
(8,1,1) = {"
a
a
a
f
p
p
p
p
p
c
"}
(9,1,1) = {"
a
a
a
f
k
k
k
k
k
k
"}
(10,1,1) = {"
b
a
a
g
k
k
k
k
k
k
"}
