//MAP CONVERTED BY dmm2tgm.py THIS HEADER COMMENT PREVENTS RECONVERSION, DO NOT REMOVE
"a" = (
/turf/simulated/floor/holofloor{
	icon_state = "wooden"
	},
/area/station/civilian/holodeck/source_meetinghall)
"b" = (
/obj/structure/table/holotable/wooden,
/turf/simulated/floor/holofloor{
	icon_state = "wooden"
	},
/area/station/civilian/holodeck/source_meetinghall)
"c" = (
/turf/simulated/floor/holofloor{
	dir = 4;
	icon_state = "carpet4-0"
	},
/area/station/civilian/holodeck/source_meetinghall)
"d" = (
/turf/simulated/floor/holofloor{
	dir = 4;
	icon_state = "carpet8-0"
	},
/area/station/civilian/holodeck/source_meetinghall)
"e" = (
/turf/simulated/floor/holofloor{
	dir = 6;
	icon_state = "carpetsymbol"
	},
/area/station/civilian/holodeck/source_meetinghall)
"f" = (
/obj/structure/window/reinforced/holowindow,
/turf/simulated/floor/holofloor{
	icon_state = "wooden"
	},
/area/station/civilian/holodeck/source_meetinghall)
"g" = (
/turf/environment/space,
/turf/simulated/floor/holofloor{
	dir = 4;
	icon_state = "carpet6-2"
	},
/area/station/civilian/holodeck/source_meetinghall)
"h" = (
/turf/environment/space,
/turf/simulated/floor/holofloor{
	dir = 4;
	icon_state = "carpet14-10"
	},
/area/station/civilian/holodeck/source_meetinghall)
"i" = (
/obj/structure/window/reinforced/holowindow{
	dir = 4
	},
/turf/environment/space,
/turf/simulated/floor/holofloor{
	dir = 4;
	icon_state = "carpet10-8"
	},
/area/station/civilian/holodeck/source_meetinghall)
"j" = (
/turf/environment/space,
/turf/simulated/floor/holofloor{
	icon_state = "wood_stairs2"
	},
/area/station/civilian/holodeck/source_meetinghall)
"k" = (
/turf/environment/space,
/turf/simulated/floor/holofloor{
	dir = 6;
	icon_state = "wood_stairs2"
	},
/area/station/civilian/holodeck/source_meetinghall)
"l" = (
/obj/structure/stool/bed/chair/holochair{
	dir = 8
	},
/turf/simulated/floor/holofloor{
	icon_state = "dark"
	},
/area/station/civilian/holodeck/source_meetinghall)
"m" = (
/obj/structure/window/reinforced/holowindow,
/obj/structure/table/holotable/wooden,
/turf/simulated/floor/holofloor{
	icon_state = "wooden"
	},
/area/station/civilian/holodeck/source_meetinghall)
"n" = (
/turf/simulated/floor/holofloor{
	dir = 4;
	icon_state = "carpet7-3"
	},
/area/station/civilian/holodeck/source_meetinghall)
"o" = (
/turf/simulated/floor/holofloor{
	dir = 4;
	icon_state = "carpet15-15"
	},
/area/station/civilian/holodeck/source_meetinghall)
"p" = (
/obj/structure/stool/bed/chair/holochair{
	dir = 1
	},
/turf/simulated/floor/holofloor{
	dir = 4;
	icon_state = "carpet15-15"
	},
/area/station/civilian/holodeck/source_meetinghall)
"q" = (
/turf/simulated/floor/holofloor{
	dir = 4;
	icon_state = "carpet11-12"
	},
/area/station/civilian/holodeck/source_meetinghall)
"r" = (
/turf/simulated/floor/holofloor{
	icon_state = "dark"
	},
/area/station/civilian/holodeck/source_meetinghall)
"s" = (
/turf/simulated/floor/holofloor{
	dir = 4;
	icon_state = "carpet5-1"
	},
/area/station/civilian/holodeck/source_meetinghall)
"t" = (
/turf/simulated/floor/holofloor{
	dir = 4;
	icon_state = "carpet13-5"
	},
/area/station/civilian/holodeck/source_meetinghall)
"u" = (
/turf/simulated/floor/holofloor{
	dir = 4;
	icon_state = "carpet9-4"
	},
/area/station/civilian/holodeck/source_meetinghall)

(1,1,1) = {"
a
a
f
g
n
n
n
n
n
s
"}
(2,1,1) = {"
a
c
f
h
p
p
p
p
p
t
"}
(3,1,1) = {"
a
d
f
h
p
p
p
p
p
t
"}
(4,1,1) = {"
a
e
f
h
o
o
o
o
o
t
"}
(5,1,1) = {"
a
c
f
h
p
p
p
p
p
t
"}
(6,1,1) = {"
a
d
f
h
p
p
p
p
p
t
"}
(7,1,1) = {"
a
a
f
i
q
q
q
q
q
u
"}
(8,1,1) = {"
a
a
a
j
r
r
r
r
r
r
"}
(9,1,1) = {"
a
a
a
k
r
r
r
r
r
r
"}
(10,1,1) = {"
b
b
b
m
l
l
l
l
l
r
"}
