//MAP CONVERTED BY dmm2tgm.py THIS HEADER COMMENT PREVENTS RECONVERSION, DO NOT REMOVE
"a" = (
/obj/structure/flora/ausbushes/fullgrass,
/turf/simulated/floor/holofloor/grass,
/area/station/civilian/holodeck/source_picnicarea)
"b" = (
/obj/structure/flora/ausbushes/ywflowers,
/turf/simulated/floor/holofloor/grass,
/area/station/civilian/holodeck/source_picnicarea)
"c" = (
/obj/structure/flora/ausbushes/brflowers,
/turf/simulated/floor/holofloor/grass,
/area/station/civilian/holodeck/source_picnicarea)
"d" = (
/turf/simulated/floor/holofloor{
	icon_state = "asteroid"
	},
/area/station/civilian/holodeck/source_picnicarea)
"e" = (
/obj/structure/holostool,
/turf/simulated/floor/holofloor{
	icon_state = "asteroid"
	},
/area/station/civilian/holodeck/source_picnicarea)
"f" = (
/obj/structure/table/holotable/wooden,
/turf/simulated/floor/holofloor{
	icon_state = "asteroid"
	},
/area/station/civilian/holodeck/source_picnicarea)
"g" = (
/obj/structure/flora/ausbushes/sunnybush,
/turf/simulated/floor/holofloor/grass,
/area/station/civilian/holodeck/source_picnicarea)
"h" = (
/obj/structure/flora/ausbushes/fullgrass,
/obj/structure/flora/ausbushes/leafybush,
/turf/simulated/floor/holofloor/grass,
/area/station/civilian/holodeck/source_picnicarea)
"i" = (
/obj/structure/flora/tree/jungle,
/turf/simulated/floor/holofloor/grass,
/area/station/civilian/holodeck/source_picnicarea)
"j" = (
/obj/structure/flora/junglebush,
/turf/simulated/floor/holofloor/grass,
/area/station/civilian/holodeck/source_picnicarea)
"k" = (
/turf/simulated/floor/holofloor/grass,
/area/station/civilian/holodeck/source_picnicarea)
"l" = (
/obj/structure/flora/ausbushes/sparsegrass,
/turf/simulated/floor/holofloor/grass,
/area/station/civilian/holodeck/source_picnicarea)
"m" = (
/obj/structure/flora/ausbushes/genericbush,
/turf/simulated/floor/holofloor/grass,
/area/station/civilian/holodeck/source_picnicarea)
"n" = (
/obj/structure/flora/ausbushes/fullgrass,
/obj/structure/flora/ausbushes/ppflowers,
/turf/simulated/floor/holofloor/grass,
/area/station/civilian/holodeck/source_picnicarea)
"o" = (
/obj/structure/flora/ausbushes/sparsegrass,
/obj/structure/flora/ausbushes/brflowers,
/turf/simulated/floor/holofloor/grass,
/area/station/civilian/holodeck/source_picnicarea)
"p" = (
/obj/structure/flora/ausbushes/sparsegrass,
/obj/structure/flora/ausbushes/ppflowers,
/turf/simulated/floor/holofloor/grass,
/area/station/civilian/holodeck/source_picnicarea)
"q" = (
/obj/structure/flora/ausbushes/brflowers,
/obj/structure/flora/ausbushes/sparsegrass,
/turf/simulated/floor/holofloor/grass,
/area/station/civilian/holodeck/source_picnicarea)
"r" = (
/obj/structure/flora/ausbushes/lavendergrass,
/obj/structure/flora/tree/jungle/small,
/turf/simulated/floor/holofloor/grass,
/area/station/civilian/holodeck/source_picnicarea)
"s" = (
/obj/structure/flora/ausbushes/fullgrass,
/obj/structure/flora/ausbushes/lavendergrass,
/turf/simulated/floor/holofloor/grass,
/area/station/civilian/holodeck/source_picnicarea)
"t" = (
/obj/structure/flora/ausbushes/ywflowers,
/obj/structure/flora/ausbushes/sparsegrass,
/turf/simulated/floor/holofloor/grass,
/area/station/civilian/holodeck/source_picnicarea)
"u" = (
/obj/structure/flora/ausbushes/fullgrass,
/obj/structure/flora/ausbushes/palebush,
/turf/simulated/floor/holofloor/grass,
/area/station/civilian/holodeck/source_picnicarea)
"v" = (
/obj/structure/flora/ausbushes/sparsegrass,
/obj/structure/flora/ausbushes/sunnybush,
/turf/simulated/floor/holofloor/grass,
/area/station/civilian/holodeck/source_picnicarea)
"w" = (
/obj/structure/flora/ausbushes/lavendergrass,
/turf/simulated/floor/holofloor{
	icon_state = "asteroid"
	},
/area/station/civilian/holodeck/source_picnicarea)
"x" = (
/obj/structure/flora/ausbushes/sparsegrass,
/obj/structure/flora/tree/jungle,
/turf/simulated/floor/holofloor/grass,
/area/station/civilian/holodeck/source_picnicarea)
"y" = (
/obj/structure/flora/ausbushes/sparsegrass,
/turf/simulated/floor/holofloor{
	icon_state = "asteroid"
	},
/area/station/civilian/holodeck/source_picnicarea)
"z" = (
/obj/structure/flora/ausbushes/pointybush,
/turf/simulated/floor/holofloor{
	icon_state = "asteroid"
	},
/area/station/civilian/holodeck/source_picnicarea)
"A" = (
/turf/simulated/floor/holofloor{
	dir = 4;
	icon_state = "asteroid2"
	},
/area/station/civilian/holodeck/source_picnicarea)

(1,1,1) = {"
a
p
s
v
a
A
l
a
a
A
"}
(2,1,1) = {"
a
c
b
j
q
b
A
b
x
A
"}
(3,1,1) = {"
a
b
i
p
l
d
y
c
m
A
"}
(4,1,1) = {"
a
q
l
b
y
e
e
d
A
d
"}
(5,1,1) = {"
h
g
q
w
d
f
A
d
d
d
"}
(6,1,1) = {"
a
c
b
x
z
A
f
d
d
d
"}
(7,1,1) = {"
a
b
c
k
A
e
e
y
d
A
"}
(8,1,1) = {"
n
k
t
c
l
b
A
y
l
d
"}
(9,1,1) = {"
a
r
q
t
q
q
A
c
l
w
"}
(10,1,1) = {"
o
a
u
l
a
a
a
A
n
a
"}
