//MAP CONVERTED BY dmm2tgm.py THIS HEADER COMMENT PREVENTS RECONVERSION, DO NOT REMOVE
"a" = (
/obj/structure/flora/ausbushes/fullgrass,
/turf/simulated/floor/holofloor/grass,
/area/station/civilian/holodeck/source_picnicarea)
"b" = (
/obj/structure/flora/ausbushes/ywflowers,
/turf/simulated/floor/holofloor/grass,
/area/station/civilian/holodeck/source_picnicarea)
"c" = (
/obj/structure/flora/ausbushes/brflowers,
/turf/simulated/floor/holofloor/grass,
/area/station/civilian/holodeck/source_picnicarea)
"d" = (
/turf/simulated/floor/holofloor{
	icon_state = "asteroid"
	},
/area/station/civilian/holodeck/source_picnicarea)
"e" = (
/obj/structure/holostool,
/turf/simulated/floor/holofloor{
	icon_state = "asteroid"
	},
/area/station/civilian/holodeck/source_picnicarea)
"f" = (
/obj/structure/table/holotable/wooden,
/turf/simulated/floor/holofloor{
	icon_state = "asteroid"
	},
/area/station/civilian/holodeck/source_picnicarea)
"g" = (
/obj/structure/flora/ausbushes/sunnybush,
/obj/structure/fence/wood{
	dir = 1
	},
/turf/simulated/floor/holofloor/grass,
/area/station/civilian/holodeck/source_picnicarea)
"h" = (
/obj/structure/flora/ausbushes/lavendergrass,
/turf/simulated/floor/holofloor/grass,
/area/station/civilian/holodeck/source_picnicarea)
"i" = (
/obj/structure/flora/tree/jungle,
/turf/simulated/floor/holofloor/grass,
/area/station/civilian/holodeck/source_picnicarea)
"j" = (
/obj/structure/flora/junglebush,
/obj/structure/fence/wood{
	dir = 8
	},
/turf/simulated/floor/holofloor/grass,
/area/station/civilian/holodeck/source_picnicarea)
"k" = (
/turf/simulated/floor/holofloor/grass,
/area/station/civilian/holodeck/source_picnicarea)
"l" = (
/obj/structure/flora/ausbushes/sparsegrass,
/turf/simulated/floor/holofloor/grass,
/area/station/civilian/holodeck/source_picnicarea)
"m" = (
/obj/structure/flora/ausbushes/genericbush,
/turf/simulated/floor/holofloor/grass,
/area/station/civilian/holodeck/source_picnicarea)
"q" = (
/obj/structure/flora/ausbushes/brflowers,
/obj/structure/fence/wood{
	dir = 8
	},
/turf/simulated/floor/holofloor/grass,
/area/station/civilian/holodeck/source_picnicarea)
"r" = (
/obj/structure/flora/ausbushes/lavendergrass,
/obj/structure/fence/wood{
	dir = 8
	},
/turf/simulated/floor/holofloor/grass,
/area/station/civilian/holodeck/source_picnicarea)
"t" = (
/obj/structure/flora/ausbushes/brflowers,
/obj/structure/fence/wood{
	dir = 4
	},
/turf/simulated/floor/holofloor/grass,
/area/station/civilian/holodeck/source_picnicarea)
"u" = (
/obj/structure/fence/wood{
	dir = 4
	},
/turf/simulated/floor/holofloor/grass,
/area/station/civilian/holodeck/source_picnicarea)
"A" = (
/obj/structure/flora/ausbushes/ywflowers,
/obj/structure/fence/wood{
	dir = 4
	},
/turf/simulated/floor/holofloor/grass,
/area/station/civilian/holodeck/source_picnicarea)
"F" = (
/obj/structure/flora/ausbushes/brflowers,
/obj/structure/fence/wood{
	dir = 1
	},
/turf/simulated/floor/holofloor/grass,
/area/station/civilian/holodeck/source_picnicarea)
"H" = (
/obj/structure/flora/ausbushes/lavendergrass,
/obj/structure/fence/wood{
	dir = 4
	},
/turf/simulated/floor/holofloor/grass,
/area/station/civilian/holodeck/source_picnicarea)
"K" = (
/obj/structure/flora/ausbushes/brflowers,
/obj/structure/fence/wood{
	dir = 8
	},
/obj/structure/fence/wood{
	dir = 1
	},
/turf/simulated/floor/holofloor/grass,
/area/station/civilian/holodeck/source_picnicarea)
"O" = (
/obj/structure/flora/ausbushes/lavendergrass,
/obj/structure/fence/wood{
	dir = 4
	},
/obj/structure/fence/wood{
	dir = 1
	},
/turf/simulated/floor/holofloor/grass,
/area/station/civilian/holodeck/source_picnicarea)
"R" = (
/obj/structure/flora/ausbushes/ywflowers,
/obj/structure/fence/wood{
	dir = 8
	},
/turf/simulated/floor/holofloor/grass,
/area/station/civilian/holodeck/source_picnicarea)
"S" = (
/obj/structure/fence/wood{
	dir = 8
	},
/turf/simulated/floor/holofloor/grass,
/area/station/civilian/holodeck/source_picnicarea)
"T" = (
/obj/structure/flora/ausbushes/ywflowers,
/obj/structure/fence/wood{
	dir = 1
	},
/turf/simulated/floor/holofloor/grass,
/area/station/civilian/holodeck/source_picnicarea)

(1,1,1) = {"
a
a
a
a
a
a
a
a
a
a
"}
(2,1,1) = {"
a
K
R
j
q
R
r
R
S
S
"}
(3,1,1) = {"
a
T
i
k
k
k
k
c
m
d
"}
(4,1,1) = {"
a
F
b
k
l
e
e
d
d
d
"}
(5,1,1) = {"
a
g
c
h
k
f
f
d
d
d
"}
(6,1,1) = {"
a
F
b
k
k
f
f
d
d
d
"}
(7,1,1) = {"
a
T
c
i
b
e
e
d
d
d
"}
(8,1,1) = {"
a
F
b
c
k
b
c
l
k
d
"}
(9,1,1) = {"
a
O
t
A
t
t
A
t
u
H
"}
(10,1,1) = {"
a
a
a
a
a
a
a
a
a
a
"}
