"a" = (/turf/simulated/floor/holofloor{icon_state = "dark"},/area/holodeck/source_thunderdomecourt)
"b" = (/obj/structure/holostool,/turf/simulated/floor/holofloor{dir = 5; icon_state = "vault"},/area/holodeck/source_thunderdomecourt)
"c" = (/obj/structure/holostool,/obj/structure/window/reinforced/holowindow,/turf/simulated/floor/holofloor{dir = 5; icon_state = "vault"},/area/holodeck/source_thunderdomecourt)
"d" = (/obj/machinery/door/window/holowindoor{base_state = "right"; dir = 2; icon_state = "right"; name = "Green Team"},/turf/simulated/floor/holofloor{icon_state = "dark"},/area/holodeck/source_thunderdomecourt)
"e" = (/obj/machinery/door/window/holowindoor{dir = 2; name = "Red Team"},/turf/simulated/floor/holofloor{icon_state = "dark"},/area/holodeck/source_thunderdomecourt)
"f" = (/obj/structure/table/holotable,/turf/simulated/floor/holofloor{dir = 9; icon_state = "green"},/area/holodeck/source_thunderdomecourt)
"g" = (/turf/simulated/floor/holofloor{dir = 1; icon_state = "green"},/area/holodeck/source_thunderdomecourt)
"h" = (/turf/simulated/floor/holofloor,/area/holodeck/source_thunderdomecourt)
"i" = (/obj/structure/window/reinforced/holowindow/disappearing{icon_state = "rwindow"; dir = 4},/turf/simulated/floor/holofloor{dir = 5; icon_state = "green"},/area/holodeck/source_thunderdomecourt)
"j" = (/obj/structure/window/reinforced/holowindow/disappearing{icon_state = "rwindow"; dir = 8},/turf/simulated/floor/holofloor{dir = 9; icon_state = "red"},/area/holodeck/source_thunderdomecourt)
"k" = (/turf/simulated/floor/holofloor{dir = 1; icon_state = "red"},/area/holodeck/source_thunderdomecourt)
"l" = (/obj/structure/table/holotable,/obj/machinery/readybutton{pixel_y = 0},/turf/simulated/floor/holofloor{dir = 5; icon_state = "red"},/area/holodeck/source_thunderdomecourt)
"m" = (/obj/structure/table/holotable,/obj/item/clothing/head/helmet/thunderdome,/obj/item/clothing/suit/armor/tdome/green,/obj/item/clothing/under/color/green,/obj/item/weapon/holo/esword/green,/turf/simulated/floor/holofloor{dir = 8; icon_state = "green"},/area/holodeck/source_thunderdomecourt)
"n" = (/obj/structure/window/reinforced/holowindow/disappearing{icon_state = "rwindow"; dir = 4},/turf/simulated/floor/holofloor{dir = 4; icon_state = "green"},/area/holodeck/source_thunderdomecourt)
"o" = (/obj/structure/window/reinforced/holowindow/disappearing{icon_state = "rwindow"; dir = 8},/turf/simulated/floor/holofloor{dir = 8; icon_state = "red"},/area/holodeck/source_thunderdomecourt)
"p" = (/obj/structure/table/holotable,/obj/item/clothing/head/helmet/thunderdome,/obj/item/clothing/suit/armor/tdome/red,/obj/item/clothing/under/color/red,/obj/item/weapon/holo/esword/red,/turf/simulated/floor/holofloor{dir = 4; icon_state = "red"},/area/holodeck/source_thunderdomecourt)
"q" = (/obj/structure/table/holotable,/obj/machinery/readybutton{pixel_y = 0},/turf/simulated/floor/holofloor{dir = 10; icon_state = "green"},/area/holodeck/source_thunderdomecourt)
"r" = (/turf/simulated/floor/holofloor{dir = 2; icon_state = "green"},/area/holodeck/source_thunderdomecourt)
"s" = (/obj/structure/window/reinforced/holowindow/disappearing{icon_state = "rwindow"; dir = 4},/turf/simulated/floor/holofloor{dir = 6; icon_state = "green"},/area/holodeck/source_thunderdomecourt)
"t" = (/obj/structure/window/reinforced/holowindow/disappearing{icon_state = "rwindow"; dir = 8},/turf/simulated/floor/holofloor{dir = 10; icon_state = "red"},/area/holodeck/source_thunderdomecourt)
"u" = (/turf/simulated/floor/holofloor{dir = 2; icon_state = "red"},/area/holodeck/source_thunderdomecourt)
"v" = (/obj/structure/table/holotable,/turf/simulated/floor/holofloor{dir = 6; icon_state = "red"},/area/holodeck/source_thunderdomecourt)

(1,1,1) = {"
aaaaaaaaaa
bbabbbbabb
ccdccccecc
fgggijkkkl
mhhhnohhhp
mhhhnohhhp
mhhhnohhhp
mhhhnohhhp
mhhhnohhhp
qrrrstuuuv
"}