//MAP CONVERTED BY dmm2tgm.py THIS HEADER COMMENT PREVENTS RECONVERSION, DO NOT REMOVE
"a" = (
/turf/simulated/floor/holofloor{
	icon_state = "dark"
	},
/area/station/civilian/holodeck/source_thunderdomecourt)
"b" = (
/obj/structure/holostool,
/turf/simulated/floor/holofloor{
	dir = 5;
	icon_state = "vault"
	},
/area/station/civilian/holodeck/source_thunderdomecourt)
"c" = (
/obj/structure/table/holotable,
/turf/simulated/floor/holofloor{
	dir = 9;
	icon_state = "red"
	},
/area/station/civilian/holodeck/source_thunderdomecourt)
"d" = (
/turf/simulated/floor/holofloor{
	dir = 1;
	icon_state = "red"
	},
/area/station/civilian/holodeck/source_thunderdomecourt)
"e" = (
/obj/structure/window/reinforced/holowindow/disappearing{
	dir = 4
	},
/turf/simulated/floor/holofloor{
	dir = 1;
	icon_state = "red"
	},
/area/station/civilian/holodeck/source_thunderdomecourt)
"f" = (
/obj/structure/window/reinforced/holowindow/disappearing{
	dir = 8
	},
/turf/simulated/floor/holofloor{
	dir = 1;
	icon_state = "green"
	},
/area/station/civilian/holodeck/source_thunderdomecourt)
"g" = (
/turf/simulated/floor/holofloor{
	dir = 1;
	icon_state = "green"
	},
/area/station/civilian/holodeck/source_thunderdomecourt)
"h" = (
/turf/simulated/floor/holofloor,
/area/station/civilian/holodeck/source_thunderdomecourt)
"i" = (
/obj/structure/table/holotable,
/obj/machinery/readybutton,
/turf/simulated/floor/holofloor{
	dir = 5;
	icon_state = "green"
	},
/area/station/civilian/holodeck/source_thunderdomecourt)
"j" = (
/obj/structure/table/holotable,
/obj/item/clothing/head/helmet/thunderdome,
/obj/item/clothing/suit/armor/tdome/red,
/obj/item/clothing/under/color/red,
/obj/item/weapon/holo/esword/red,
/turf/simulated/floor/holofloor{
	dir = 8;
	icon_state = "red"
	},
/area/station/civilian/holodeck/source_thunderdomecourt)
"k" = (
/obj/structure/window/reinforced/holowindow/disappearing{
	dir = 4
	},
/turf/simulated/floor/holofloor,
/area/station/civilian/holodeck/source_thunderdomecourt)
"l" = (
/obj/structure/window/reinforced/holowindow/disappearing{
	dir = 8
	},
/turf/simulated/floor/holofloor,
/area/station/civilian/holodeck/source_thunderdomecourt)
"m" = (
/obj/structure/table/holotable,
/obj/item/clothing/head/helmet/thunderdome,
/obj/item/clothing/suit/armor/tdome/green,
/obj/item/clothing/under/color/green,
/obj/item/weapon/holo/esword/green,
/turf/simulated/floor/holofloor{
	dir = 4;
	icon_state = "green"
	},
/area/station/civilian/holodeck/source_thunderdomecourt)
"n" = (
/obj/structure/table/holotable,
/obj/machinery/readybutton,
/turf/simulated/floor/holofloor{
	dir = 10;
	icon_state = "red"
	},
/area/station/civilian/holodeck/source_thunderdomecourt)
"o" = (
/turf/simulated/floor/holofloor{
	icon_state = "red"
	},
/area/station/civilian/holodeck/source_thunderdomecourt)
"p" = (
/obj/structure/window/reinforced/holowindow/disappearing{
	dir = 4
	},
/turf/simulated/floor/holofloor{
	icon_state = "red"
	},
/area/station/civilian/holodeck/source_thunderdomecourt)
"q" = (
/obj/structure/window/reinforced/holowindow/disappearing{
	dir = 8
	},
/turf/simulated/floor/holofloor{
	icon_state = "green"
	},
/area/station/civilian/holodeck/source_thunderdomecourt)
"r" = (
/turf/simulated/floor/holofloor{
	icon_state = "green"
	},
/area/station/civilian/holodeck/source_thunderdomecourt)
"s" = (
/obj/structure/table/holotable,
/turf/simulated/floor/holofloor{
	dir = 6;
	icon_state = "green"
	},
/area/station/civilian/holodeck/source_thunderdomecourt)
"t" = (
/obj/structure/holostool,
/obj/structure/window/reinforced/holowindow{
	dir = 1
	},
/turf/simulated/floor/holofloor{
	dir = 5;
	icon_state = "vault"
	},
/area/station/civilian/holodeck/source_thunderdomecourt)
"u" = (
/obj/machinery/door/window/holowindoor{
	dir = 1;
	name = "Red Team"
	},
/turf/simulated/floor/holofloor{
	icon_state = "dark"
	},
/area/station/civilian/holodeck/source_thunderdomecourt)
"v" = (
/obj/machinery/door/window/holowindoor{
	dir = 1;
	name = "Green Team"
	},
/turf/simulated/floor/holofloor{
	icon_state = "dark"
	},
/area/station/civilian/holodeck/source_thunderdomecourt)

(1,1,1) = {"
c
j
j
j
j
j
n
t
b
a
"}
(2,1,1) = {"
d
h
h
h
h
h
o
t
b
a
"}
(3,1,1) = {"
d
h
h
h
h
h
o
u
a
a
"}
(4,1,1) = {"
d
h
h
h
h
h
o
t
b
a
"}
(5,1,1) = {"
e
k
k
k
k
k
p
t
b
a
"}
(6,1,1) = {"
f
l
l
l
l
l
q
t
b
a
"}
(7,1,1) = {"
g
h
h
h
h
h
r
t
b
a
"}
(8,1,1) = {"
g
h
h
h
h
h
r
v
a
a
"}
(9,1,1) = {"
g
h
h
h
h
h
r
t
b
a
"}
(10,1,1) = {"
i
m
m
m
m
m
s
t
b
a
"}
