"af" = (/obj/structure/alien/weeds,/mob/living/simple_animal/hostile/xenomorph,/obj/machinery/atmospherics/pipe/simple/hidden/supply{dir = 6},/turf/simulated/shuttle/floor/vox,/area/space)
"ap" = (/obj/structure/alien/weeds,/obj/item/device/radio/intercom{name = "Station Intercom (General)"; pixel_y = 22},/turf/simulated/shuttle/floor/vox,/area/space)
"aY" = (/obj/structure/window/reinforced{dir = 1},/obj/structure/shuttle/engine/heater{icon_state = "heater1"},/turf/simulated/shuttle/floor/vox{icon_state = "floorplace"},/area/space)
"du" = (/obj/structure/alien/weeds,/obj/machinery/light_construct/small{dir = 4},/turf/simulated/shuttle/floor/vox,/area/space)
"ea" = (/obj/structure/alien/weeds,/obj/structure/alien/weeds/node,/obj/machinery/atmospherics/components/unary/vent_pump/on{dir = 1},/obj/machinery/power/terminal,/obj/structure/cable,/turf/simulated/shuttle/floor/vox,/area/space)
"eq" = (/obj/structure/alien/weeds,/obj/structure/alien{desc = "It looks like a weird egg"; icon_state = "egg"; name = "egg"},/turf/simulated/shuttle/floor/vox,/area/space)
"fs" = (/obj/structure/stool/bed,/obj/item/weapon/bedsheet/purple,/obj/structure/alien/weeds,/obj/structure/alien/weeds/node,/obj/machinery/light_construct/small{dir = 4},/obj/item/device/radio/intercom{name = "Station Intercom (General)"; pixel_x = 28; pixel_y = -5},/turf/simulated/shuttle/floor/vox,/area/space)
"gx" = (/obj/structure/table/reinforced,/obj/item/stack/sheet/mineral/phoron{amount = 5; layer = 2.9},/obj/structure/alien/weeds,/obj/item/weapon/storage/bag/fossils,/obj/structure/cable{d2 = 4; icon_state = "0-4"},/obj/machinery/power/apc/largecell{dir = 8; name = "largecell apc left"; pixel_x = -28},/turf/simulated/shuttle/floor/vox,/area/space)
"gY" = (/obj/structure/alien/weeds,/obj/effect/landmark/corpse/scientist,/turf/simulated/shuttle/floor/vox,/area/space)
"ie" = (/obj/structure/object_wall/standart{icon_state = "diagonalWall3"},/turf/environment/space,/area/space)
"ik" = (/obj/structure/alien/weeds,/obj/structure/alien/weeds/node,/obj/item/clothing/mask/facehugger{icon_state = "facehugger_dead"; stat = 2},/turf/simulated/shuttle/floor/vox,/area/space)
"nL" = (/obj/structure/closet/crate/scicrate,/obj/item/weapon/fossil/bone,/obj/item/weapon/fossil/bone,/obj/item/weapon/fossil/plant,/obj/item/weapon/fossil/bone,/obj/structure/alien/weeds,/turf/simulated/shuttle/floor/vox,/area/space)
"nP" = (/obj/item/weapon/shard,/obj/structure/alien/weeds,/turf/simulated/shuttle/floor/vox,/area/space)
"of" = (/obj/structure/alien/weeds,/obj/structure/alien/weeds/node,/obj/effect/decal/remains/human,/turf/simulated/shuttle/floor/vox,/area/space)
"ot" = (/obj/structure/alien/weeds,/obj/structure/closet/crate/freezer{opened = 1},/obj/random/foods/donuts,/obj/item/weapon/reagent_containers/food/snacks/meatsteak,/obj/item/pizzabox/mushroom,/turf/simulated/shuttle/floor/vox,/area/space)
"pi" = (/obj/structure/alien/weeds,/obj/structure/alien/weeds/node,/obj/item/weapon/gun/energy/gun,/turf/simulated/shuttle/floor/vox,/area/space)
"qf" = (/obj/structure/object_wall/standart{dir = 1; icon_state = "diagonalWall3"},/turf/environment/space,/area/space)
"qn" = (/obj/structure/table/reinforced,/obj/structure/alien/weeds,/obj/structure/alien/weeds/node,/obj/machinery/light_construct/small{dir = 8},/obj/item/weapon/storage/fancy/donut_box/traitor,/turf/simulated/shuttle/floor/vox,/area/space)
"rS" = (/obj/structure/computerframe,/obj/structure/alien/weeds,/turf/simulated/shuttle/floor/vox,/area/space)
"sb" = (/obj/structure/alien/weeds,/obj/structure/alien/weeds/node,/obj/machinery/atmospherics/pipe/simple/hidden/supply,/turf/simulated/shuttle/floor/vox,/area/space)
"tt" = (/obj/structure/closet/secure_closet/xenoarchaeologist_tools,/obj/structure/alien/weeds,/obj/structure/alien/weeds/node,/turf/simulated/shuttle/floor/vox,/area/space)
"us" = (/obj/structure/alien/weeds,/obj/structure/alien/weeds/node,/obj/machinery/suit_storage_unit/science,/obj/machinery/firealarm{dir = 1; pixel_y = -22},/turf/simulated/shuttle/floor/vox,/area/space)
"uN" = (/obj/machinery/atmospherics/pipe/manifold/visible{dir = 4},/turf/simulated/shuttle/floor/vox{icon_state = "floorplating"},/area/space)
"uR" = (/obj/structure/alien/weeds,/obj/structure/door_assembly/door_assembly_hatch,/obj/machinery/atmospherics/components/unary/vent_pump/on{dir = 1},/turf/simulated/shuttle/floor/vox,/area/space)
"uV" = (/obj/structure/alien/weeds,/obj/machinery/light_construct/small,/obj/machinery/power/smes,/obj/structure/cable{d2 = 8; icon_state = "0-8"},/obj/machinery/firealarm{dir = 1; pixel_y = -22},/turf/simulated/shuttle/floor/vox,/area/space)
"vd" = (/obj/structure/stool/bed,/obj/item/weapon/bedsheet/purple,/obj/structure/alien/weeds,/obj/machinery/alarm{pixel_y = 22},/turf/simulated/shuttle/floor/vox,/area/space)
"wO" = (/obj/structure/alien/weeds,/obj/structure/alien/weeds/node,/obj/structure/alien{desc = "It looks like a weird egg"; icon_state = "egg"; name = "egg"},/turf/simulated/shuttle/floor/vox,/area/space)
"xE" = (/obj/machinery/door/poddoor,/obj/structure/grille{destroyed = 1},/turf/simulated/floor/plating,/area/space)
"xZ" = (/obj/structure/object_wall/standart{icon_state = "wall3"},/turf/simulated/shuttle/floor/vox{icon_state = "floorplating"},/area/space)
"ya" = (/obj/structure/alien/weeds,/obj/machinery/door/airlock/hatch,/obj/machinery/atmospherics/pipe/simple/hidden/supply,/turf/simulated/shuttle/floor/vox,/area/space)
"zF" = (/obj/structure/rack,/obj/item/weapon/gun/energy/kinetic_accelerator{pixel_x = 3},/obj/structure/alien/weeds,/obj/structure/alien/weeds/node,/obj/item/weapon/pickaxe/drill,/obj/item/clothing/head/helmet/space/rig/science,/obj/item/weapon/tank/oxygen,/obj/item/weapon/pickaxe,/obj/machinery/alarm{pixel_y = -32},/turf/simulated/shuttle/floor/vox,/area/space)
"Af" = (/obj/structure/scrap_cube,/turf/environment/space,/area/space)
"AC" = (/obj/structure/alien/weeds,/obj/structure/alien/weeds/node,/obj/item/weapon/shard{icon_state = "small"},/obj/machinery/atmospherics/components/unary/vent_pump/on{dir = 8},/turf/simulated/shuttle/floor/vox,/area/space)
"BY" = (/obj/structure/alien/weeds,/obj/structure/alien/weeds/node,/obj/machinery/atmospherics/pipe/manifold4w/hidden/supply,/obj/structure/cable{d1 = 4; d2 = 8; icon_state = "4-8"},/turf/simulated/shuttle/floor/vox,/area/space)
"DK" = (/obj/structure/object_wall/standart{dir = 4; icon_state = "diagonalWall3"},/turf/environment/space,/area/space)
"Es" = (/obj/structure/alien/weeds,/obj/machinery/portable_atmospherics/canister/oxygen,/obj/machinery/atmospherics/pipe/simple/hidden/supply,/turf/simulated/shuttle/floor/vox,/area/space)
"Ex" = (/obj/machinery/atmospherics/pipe/simple/hidden/universal{dir = 4},/obj/machinery/door/airlock/external{frequency = 1379; id_tag = "alien_der_inner"; name = "Research Ship External Access"},/obj/structure/cable{d1 = 4; d2 = 8; icon_state = "4-8"},/turf/simulated/shuttle/floor/vox{icon_state = "floorplace"},/area/space)
"EU" = (/obj/structure/alien/weeds,/turf/simulated/shuttle/floor/vox,/area/space)
"EZ" = (/obj/structure/alien/weeds,/obj/structure/alien/weeds/node,/turf/simulated/shuttle/floor/vox,/area/space)
"Fh" = (/obj/structure/stool/bed,/obj/item/weapon/bedsheet/purple,/obj/structure/alien/weeds,/obj/structure/alien/weeds/node,/turf/simulated/shuttle/floor/vox,/area/space)
"Fq" = (/obj/structure/window/reinforced{dir = 8},/obj/structure/window/reinforced{dir = 4},/obj/machinery/door/firedoor,/obj/structure/grille{destroyed = 1},/turf/simulated/floor/plating,/area/space)
"Fu" = (/obj/machinery/r_n_d/destructive_analyzer,/obj/structure/alien/weeds/node,/turf/simulated/shuttle/floor/vox,/area/space)
"FD" = (/obj/structure/grille,/obj/structure/window/reinforced{dir = 1},/obj/structure/window/reinforced,/obj/structure/window/reinforced{dir = 8},/obj/structure/window/reinforced{dir = 4},/obj/machinery/door/firedoor,/turf/simulated/floor/plating,/area/space)
"FL" = (/obj/structure/alien/weeds,/obj/machinery/atmospherics/pipe/simple/hidden/supply{dir = 4},/obj/structure/cable{d1 = 4; d2 = 8; icon_state = "4-8"},/turf/simulated/shuttle/floor/vox,/area/space)
"FT" = (/obj/effect/landmark/corpse/scientist,/obj/structure/alien/weeds,/obj/structure/alien/weeds/node,/turf/simulated/shuttle/floor/vox,/area/space)
"Hd" = (/obj/structure/alien/weeds,/obj/machinery/light_construct/small,/obj/machinery/suit_storage_unit/science,/obj/item/device/radio/intercom{name = "Station Intercom (General)"; pixel_y = -32},/turf/simulated/shuttle/floor/vox,/area/space)
"Ig" = (/obj/machinery/atmospherics/pipe/simple/visible{dir = 10},/obj/structure/cable{d1 = 4; d2 = 8; icon_state = "4-8"},/turf/simulated/shuttle/floor/vox{icon_state = "floorplating"},/area/space)
"Iz" = (/obj/item/weapon/shard{icon_state = "small"},/obj/machinery/computer/reconstitutor/animal,/obj/structure/alien/weeds,/obj/machinery/alarm{pixel_x = -28; pixel_y = -6},/turf/simulated/shuttle/floor/vox,/area/space)
"Ju" = (/obj/structure/alien/weeds,/obj/structure/alien/weeds/node,/obj/item/device/flashlight/seclite{on = 1},/turf/simulated/shuttle/floor/vox,/area/space)
"Kb" = (/obj/item/weapon/ore/glass,/turf/environment/space,/area/space)
"Lj" = (/obj/item/weapon/scrap_lump,/turf/environment/space,/area/space)
"LF" = (/turf/environment/space,/area/space)
"LJ" = (/obj/structure/computerframe{dir = 4},/obj/item/weapon/disk/research_points,/obj/structure/alien/weeds,/obj/structure/alien/weeds/node,/obj/item/device/radio/intercom{name = "Station Intercom (General)"; pixel_x = -28; pixel_y = -5},/turf/simulated/shuttle/floor/vox,/area/space)
"NF" = (/obj/structure/alien/weeds,/obj/structure/alien/weeds/node,/mob/living/simple_animal/hostile/xenomorph/drone,/obj/machinery/atmospherics/pipe/simple/hidden/supply{dir = 6},/obj/structure/cable{d1 = 2; d2 = 4; icon_state = "2-4"},/turf/simulated/shuttle/floor/vox,/area/space)
"OD" = (/obj/structure/alien/weeds,/obj/item/weapon/shard{icon_state = "medium"},/obj/machinery/access_button{command = "cycle_interior"; frequency = 1379; master_tag = "alien_der_airlock"; name = "interior access button"; pixel_x = 28},/turf/simulated/shuttle/floor/vox,/area/space)
"OL" = (/obj/machinery/atmospherics/pipe/simple/visible{dir = 4},/obj/machinery/embedded_controller/radio/airlock_controller{id_tag = "alien_der_airlock"; pixel_y = 28; tag_airpump = "alien_der_pump"; tag_chamber_sensor = "alien_der_sensor"; tag_exterior_door = "alien_der_outer"; tag_interior_door = "alien_der_inner"},/obj/structure/cable{d1 = 4; d2 = 8; icon_state = "4-8"},/turf/simulated/shuttle/floor/vox{icon_state = "floorplating"},/area/space)
"ON" = (/obj/machinery/clonepod,/obj/structure/alien/weeds,/turf/simulated/shuttle/floor/vox,/area/space)
"Qm" = (/obj/structure/computerframe,/obj/structure/alien/weeds,/obj/structure/alien/weeds/node,/turf/simulated/shuttle/floor/vox,/area/space)
"Qr" = (/obj/structure/table/reinforced,/obj/structure/alien/weeds,/obj/item/pizzabox/meat,/obj/machinery/firealarm{pixel_y = 24},/turf/simulated/shuttle/floor/vox,/area/space)
"Qw" = (/obj/structure/computerframe,/obj/structure/alien/weeds,/obj/machinery/light_construct/small{dir = 1},/turf/simulated/shuttle/floor/vox,/area/space)
"Sm" = (/obj/structure/shuttle/engine/propulsion,/turf/environment/space,/area/space)
"SX" = (/obj/structure/grille,/obj/structure/window/reinforced{dir = 5},/obj/machinery/door/poddoor,/turf/simulated/floor/plating,/area/space)
"TU" = (/obj/machinery/atmospherics/components/unary/tank/air{dir = 1},/turf/simulated/shuttle/floor/vox{icon_state = "floorplating"},/area/space)
"UR" = (/obj/structure/alien/weeds,/obj/structure/alien/weeds/node,/obj/machinery/light_construct/small{dir = 8},/turf/simulated/shuttle/floor/vox,/area/space)
"UV" = (/obj/structure/alien/weeds,/mob/living/simple_animal/hostile/xenomorph,/turf/simulated/shuttle/floor/vox,/area/space)
"Wq" = (/obj/machinery/light_construct/small,/obj/machinery/atmospherics/components/unary/vent_pump/high_volume{dir = 4; frequency = 1379; id_tag = "alien_der"; name = "Research Ship Large Air Vent"},/obj/machinery/airlock_sensor{id_tag = "alien_der_sensor"; layer = 3.3; pixel_x = -28},/obj/item/device/radio/intercom{name = "Station Intercom (General)"; pixel_y = -32},/turf/simulated/shuttle/floor/vox{icon_state = "floorplating"},/area/space)
"WM" = (/obj/item/weapon/ore/iron,/turf/environment/space,/area/space)
"Xw" = (/obj/machinery/door/airlock/external{frequency = 1379; id_tag = "alien_der_outer"; name = "Research Ship External Access"},/obj/structure/cable{d2 = 8; icon_state = "0-8"},/turf/simulated/shuttle/floor/vox{icon_state = "floorplace"},/area/space)
"Yj" = (/obj/machinery/access_button{command = "cycle_exterior"; frequency = 1379; master_tag = "alien_der_airlock"; name = "exterior access button"; pixel_x = -28},/turf/environment/space,/area/space)
"Zm" = (/obj/structure/object_wall/standart{dir = 8; icon_state = "diagonalWall3"},/turf/environment/space,/area/space)

(1,1,1) = {"
LFLFLFLFLFLFLFLFLFKbLFLFLFLFLF
LFLFLFLFZmxZxZxZxZxZqfLFLFLFLF
LFAfZmxZxZxZxZxZxZxZxZxZqfLFLF
LFLFxZxZxZxZxZxZQmQwrSxZxZLFLF
LFLFxZEUapwOxZQrpiofJuvdxZLFLF
LFLFxZURONduxZqnafACeqfsxZLFLF
LFLFxZEZEZnPxZotsbEZgYFhxZLFLF
LFZmxZSXEUxExZFDyaFqxZxZxZqfWM
LFxZxZIzikEZxZttEsODxZxZxZxZYj
LFxZLJFTNFFLFLFLBYFLExOLIgXwLF
LFxZFueqeanLxZEZuRUVxZWquNxZLF
LFxZxZgxuVxZxZzFHdusxZxZTUxZLF
LFxZaYaYxZxZxZxZxZxZxZaYaYxZLF
LFieSmSmxZaYaYxZaYaYxZSmSmDKLF
LFLFLFLFieSmSmxZSmSmDKLFLFLjLF
LFLFLFLFKbLFLFLFLFLFLFLFLFLFLF
"}
