//MAP CONVERTED BY dmm2tgm.py THIS HEADER COMMENT PREVENTS RECONVERSION, DO NOT REMOVE
"aa" = (
/obj/structure/cult/anomaly/timewhole,
/turf/environment/space,
/area/space)
"ay" = (
/obj/item/weapon/ore/iron,
/turf/environment/space,
/area/space)
"aT" = (
/obj/structure/object_wall/standart{
	dir = 8;
	icon_state = "diagonalWall3"
	},
/turf/environment/space,
/area/space)
"aV" = (
/turf/simulated/wall/cult,
/area/space)
"bc" = (
/turf/simulated/wall/cult/runed/anim,
/area/space)
"by" = (
/obj/structure/object_wall/standart{
	icon_state = "wall3"
	},
/turf/simulated/floor/engine/cult,
/area/space)
"bQ" = (
/obj/machinery/door/airlock/hatch,
/obj/structure/fans/tiny,
/turf/simulated/floor/engine/cult/lava,
/area/space)
"bV" = (
/obj/structure/object_wall/standart{
	dir = 1;
	icon_state = "diagonalWall3"
	},
/turf/environment/space,
/area/space)
"cf" = (
/obj/structure/scrap_cube,
/turf/environment/space,
/area/space)
"ej" = (
/obj/structure/shuttle/engine/propulsion{
	dir = 8;
	icon_state = "burst_l"
	},
/turf/environment/space,
/area/space)
"eD" = (
/obj/structure/window/reinforced{
	dir = 4
	},
/obj/structure/shuttle/engine/heater{
	dir = 8;
	icon_state = "heater1"
	},
/turf/simulated/floor/engine/cult/lava,
/area/space)
"fE" = (
/obj/machinery/portable_atmospherics/canister/oxygen,
/turf/simulated/shuttle/floor/evac/eng2,
/area/space)
"fV" = (
/obj/effect/decal/cleanable/blood/drip,
/obj/effect/decal/cleanable/dirt,
/turf/simulated/shuttle/floor/evac/eng2,
/area/space)
"gk" = (
/turf/simulated/floor/engine/cult,
/area/space)
"gl" = (
/obj/machinery/recharge_station,
/turf/simulated/shuttle/floor/evac/eng2,
/area/space)
"gZ" = (
/obj/structure/shuttle/engine/propulsion{
	dir = 8
	},
/turf/environment/space,
/area/space)
"hp" = (
/obj/structure/dispenser/oxygen,
/turf/simulated/floor/engine/cult,
/area/space)
"hD" = (
/obj/structure/cult/anomaly/orb,
/obj/effect/decal/cleanable/dirt,
/turf/simulated/floor/engine/cult/lava,
/area/space)
"hU" = (
/obj/effect/decal/cleanable/blood,
/turf/simulated/floor/engine/cult,
/area/space)
"ih" = (
/obj/machinery/light_construct/small{
	dir = 4
	},
/turf/simulated/floor/engine/cult,
/area/space)
"iU" = (
/obj/structure/extinguisher_cabinet{
	pixel_y = 29
	},
/obj/machinery/bodyscanner,
/obj/item/weapon/storage/firstaid/adv,
/turf/simulated/shuttle/floor/evac/eng2,
/area/space)
"ja" = (
/obj/item/device/radio/intercom{
	name = "Station Intercom (General)";
	pixel_y = 22
	},
/obj/machinery/body_scanconsole,
/obj/effect/decal/cleanable/dirt,
/obj/item/device/flashlight/seclite,
/turf/simulated/shuttle/floor/evac/eng2,
/area/space)
"jh" = (
/obj/machinery/sleeper{
	dir = 8
	},
/turf/simulated/floor/engine/cult,
/area/space)
"jo" = (
/obj/structure/shuttle/engine/propulsion{
	dir = 8;
	icon_state = "burst_r"
	},
/turf/environment/space,
/area/space)
"lJ" = (
/obj/structure/window/reinforced{
	dir = 4
	},
/obj/structure/shuttle/engine/heater{
	dir = 8;
	icon_state = "heater1"
	},
/turf/simulated/shuttle/floor/evac/eng1,
/area/space)
"lY" = (
/obj/effect/decal/cleanable/blood/gibs/down,
/obj/effect/decal/cleanable/dirt,
/turf/simulated/floor/engine/cult,
/area/space)
"mM" = (
/obj/effect/decal/cleanable/dirt,
/turf/simulated/shuttle/floor/evac/eng2,
/area/space)
"mS" = (
/obj/structure/mineral_door/cult,
/turf/simulated/floor/engine/cult/lava,
/area/space)
"oy" = (
/obj/effect/decal/cleanable/blood/drip,
/obj/effect/decal/cleanable/dirt,
/turf/simulated/floor/engine/cult,
/area/space)
"oH" = (
/mob/living/simple_animal/hostile/cellular/meat/flesh,
/turf/simulated/floor/engine/cult,
/area/space)
"oM" = (
/obj/effect/decal/cleanable/blood/gibs,
/obj/effect/decal/remains/human,
/turf/simulated/floor/engine/cult/lava,
/area/space)
"pe" = (
/obj/effect/decal/cleanable/blood,
/obj/structure/door_assembly/door_assembly_hatch,
/turf/simulated/shuttle/floor/evac/eng2,
/area/space)
"pq" = (
/obj/item/weapon/reagent_containers/glass/bucket/full,
/obj/item/weapon/mop,
/turf/simulated/floor/engine/cult,
/area/space)
"qK" = (
/obj/structure/cult/anomaly/shell,
/turf/environment/space,
/area/space)
"qV" = (
/obj/structure/object_wall/standart{
	icon_state = "diagonalWall3"
	},
/turf/environment/space,
/area/space)
"rK" = (
/obj/structure/stool/bed/chair/schair/wagon{
	dir = 4
	},
/obj/item/device/radio/intercom{
	name = "Station Intercom (General)";
	pixel_x = -28;
	pixel_y = -5
	},
/turf/simulated/floor/engine/cult,
/area/space)
"sd" = (
/obj/effect/decal/cleanable/blood/drip,
/obj/effect/decal/remains/human,
/obj/effect/decal/cleanable/dirt,
/turf/simulated/floor/engine/cult,
/area/space)
"sq" = (
/turf/simulated/shuttle/floor/evac/eng2,
/area/space)
"sG" = (
/obj/structure/sink{
	dir = 8;
	pixel_x = -12
	},
/turf/simulated/floor/engine/cult,
/area/space)
"sM" = (
/obj/effect/landmark/corpse/securityofficer,
/obj/effect/decal/cleanable/blood,
/obj/effect/decal/cleanable/dirt,
/turf/simulated/floor/engine/cult,
/area/space)
"tq" = (
/obj/structure/cult/anomaly/timewhole,
/obj/effect/decal/cleanable/dirt,
/obj/machinery/light_construct/small,
/turf/simulated/floor/engine/cult,
/area/space)
"tJ" = (
/obj/effect/decal/cleanable/blood/drip,
/obj/effect/decal/cleanable/dirt,
/obj/item/weapon/gun/projectile/glock/spec,
/turf/simulated/floor/engine/cult,
/area/space)
"uJ" = (
/obj/item/weapon/storage/firstaid/regular,
/turf/simulated/floor/engine/cult,
/area/space)
"uT" = (
/obj/structure/table,
/obj/machinery/cell_charger{
	pixel_y = 5
	},
/turf/simulated/floor/engine/cult,
/area/space)
"vb" = (
/obj/effect/decal/cleanable/blood/drip,
/obj/structure/stool/bed/chair/schair/wagon{
	dir = 4
	},
/obj/effect/decal/cleanable/dirt,
/turf/simulated/shuttle/floor/evac/eng2,
/area/space)
"vh" = (
/obj/effect/decal/cleanable/blood/gibs/core,
/obj/effect/decal/cleanable/dirt,
/turf/simulated/floor/engine/cult/lava,
/area/space)
"vR" = (
/obj/structure/reagent_dispensers/fueltank,
/obj/machinery/light/small{
	dir = 4
	},
/turf/simulated/floor/engine/cult,
/area/space)
"wd" = (
/obj/structure/rack,
/obj/item/weapon/storage/belt/utility{
	pixel_y = 4
	},
/obj/item/weapon/storage/toolbox/mechanical,
/turf/simulated/floor/engine/cult/lava,
/area/space)
"wv" = (
/turf/simulated/shuttle/floor/evac/eng1,
/area/space)
"wy" = (
/obj/structure/table,
/obj/item/pizzabox/meat{
	pixel_y = 10
	},
/turf/simulated/shuttle/floor/evac/eng2,
/area/space)
"wL" = (
/obj/structure/table,
/obj/item/device/radio/intercom{
	name = "Station Intercom (General)";
	pixel_y = 22
	},
/obj/machinery/recharger{
	pixel_y = 4
	},
/turf/simulated/shuttle/floor/evac/eng2,
/area/space)
"wR" = (
/obj/effect/decal/cleanable/blood/drip,
/obj/structure/stool/bed/chair/schair/wagon{
	dir = 4
	},
/turf/simulated/shuttle/floor/evac/eng2,
/area/space)
"xd" = (
/obj/effect/decal/cleanable/dirt,
/turf/simulated/floor/engine/cult,
/area/space)
"xK" = (
/obj/structure/reagent_dispensers/watertank,
/turf/simulated/floor/engine/cult,
/area/space)
"yh" = (
/obj/structure/rack,
/obj/item/stack/sheet/metal{
	amount = 15;
	pixel_x = -6
	},
/obj/item/stack/sheet/glass{
	amount = 17
	},
/turf/simulated/floor/engine/cult,
/area/space)
"yX" = (
/obj/machinery/autolathe{
	desc = "Your typical Autolathe. It appears to have much more options than your regular one, however...";
	hacked = 1;
	name = "Thunderdome Autolathe"
	},
/turf/simulated/shuttle/floor/evac/eng2,
/area/space)
"zi" = (
/obj/item/weapon/disk/research_points/rare,
/obj/structure/closet/crate/scicrate,
/turf/simulated/shuttle/floor/evac/eng2,
/area/space)
"zj" = (
/obj/effect/decal/cleanable/blood/gibs/limb,
/obj/effect/decal/cleanable/dirt,
/turf/simulated/floor/engine/cult/lava,
/area/space)
"zO" = (
/obj/structure/cult/anomaly/shell,
/obj/effect/decal/cleanable/dirt,
/turf/simulated/floor/engine/cult/lava,
/area/space)
"zS" = (
/obj/structure/stool/bed/chair/schair/wagon{
	dir = 4
	},
/obj/effect/decal/cleanable/blood/drip,
/obj/effect/decal/cleanable/dirt,
/obj/structure/door_assembly/door_assembly_hatch,
/turf/simulated/shuttle/floor/evac/eng2,
/area/space)
"Af" = (
/obj/structure/computerframe{
	dir = 8
	},
/turf/simulated/floor/engine/cult/lava,
/area/space)
"AA" = (
/obj/item/device/radio/intercom{
	name = "Station Intercom (General)";
	pixel_x = -28;
	pixel_y = -5
	},
/obj/machinery/light_construct/small{
	dir = 8
	},
/obj/machinery/vending/cigarette,
/turf/simulated/floor/engine/cult,
/area/space)
"Ca" = (
/obj/effect/decal/cleanable/blood/gibs/up,
/obj/effect/decal/cleanable/dirt,
/turf/simulated/floor/engine/cult/lava,
/area/space)
"Dr" = (
/obj/effect/decal/cleanable/blood/drip,
/mob/living/simple_animal/hostile/cellular/meat/creep_standing,
/turf/simulated/floor/engine/cult,
/area/space)
"DY" = (
/turf/simulated/floor/engine/cult/lava,
/area/space)
"EH" = (
/obj/effect/decal/cleanable/blood,
/obj/effect/decal/remains/human,
/obj/effect/decal/cleanable/dirt,
/turf/simulated/floor/engine/cult,
/area/space)
"EN" = (
/obj/structure/stool/bed/chair/schair/wagon{
	dir = 4
	},
/obj/effect/decal/cleanable/blood/drip,
/turf/simulated/floor/engine/cult,
/area/space)
"Fe" = (
/obj/structure/computerframe{
	dir = 8
	},
/obj/machinery/light/small{
	dir = 4
	},
/turf/simulated/floor/engine/cult,
/area/space)
"FK" = (
/obj/effect/decal/cleanable/blood/drip,
/obj/structure/closet/crate,
/obj/random/tools/tool,
/obj/random/tools/tool,
/obj/random/tools/tool,
/obj/random/tools/tool,
/obj/random/tools/toolbox,
/turf/simulated/floor/engine/cult,
/area/space)
"FL" = (
/obj/machinery/computer/mech_bay_power_console,
/turf/simulated/shuttle/floor/evac/eng2,
/area/space)
"FW" = (
/obj/structure/pedestal/cult,
/obj/effect/decal/cleanable/dirt,
/turf/simulated/floor/engine/cult/lava,
/area/space)
"FX" = (
/obj/structure/table/woodentable/fancy/black,
/obj/item/device/soulstone{
	pixel_y = 6
	},
/turf/simulated/floor/engine/cult/lava,
/area/space)
"Gy" = (
/obj/machinery/vending/coffee,
/turf/simulated/floor/engine/cult,
/area/space)
"GP" = (
/obj/structure/cult/anomaly/spacewhole,
/turf/simulated/shuttle/floor/evac/eng2,
/area/space)
"Ha" = (
/obj/effect/decal/cleanable/blood/drip,
/turf/simulated/shuttle/floor/evac/eng2,
/area/space)
"Hg" = (
/obj/structure/stool/bed/chair/schair/wagon{
	dir = 4
	},
/obj/effect/decal/cleanable/blood/gibs,
/obj/effect/decal/cleanable/dirt,
/obj/item/weapon/gun/energy/gun,
/turf/simulated/floor/engine/cult/lava,
/area/space)
"Hy" = (
/obj/structure/computerframe{
	dir = 8
	},
/obj/effect/decal/cleanable/dirt,
/turf/simulated/shuttle/floor/evac/eng2,
/area/space)
"HN" = (
/obj/item/weapon/scrap_lump,
/turf/environment/space,
/area/space)
"Ia" = (
/obj/structure/stool/bed/chair/schair/wagon{
	dir = 4
	},
/turf/simulated/floor/engine/cult/lava,
/area/space)
"IG" = (
/obj/effect/decal/cleanable/blood,
/obj/effect/decal/cleanable/dirt,
/turf/simulated/floor/engine/cult,
/area/space)
"JA" = (
/obj/effect/decal/mecha_wreckage/ripley/deathripley,
/obj/effect/decal/cleanable/dirt,
/obj/machinery/light/small{
	dir = 4
	},
/turf/simulated/shuttle/floor/evac/eng2,
/area/space)
"JG" = (
/obj/item/weapon/bananapeel,
/obj/effect/decal/cleanable/dirt,
/turf/simulated/floor/engine/cult/lava,
/area/space)
"Kf" = (
/obj/effect/decal/cleanable/blood/gibs/core,
/obj/effect/decal/cleanable/dirt,
/turf/simulated/floor/engine/cult,
/area/space)
"Kr" = (
/obj/effect/decal/cleanable/dirt,
/obj/machinery/constructable_frame/machine_frame,
/turf/simulated/shuttle/floor/evac/eng2,
/area/space)
"KA" = (
/obj/structure/table,
/obj/item/weapon/handcuffs,
/obj/item/device/radio/intercom{
	name = "Station Intercom (General)";
	pixel_y = -32
	},
/turf/simulated/floor/engine/cult,
/area/space)
"LA" = (
/obj/effect/decal/cleanable/blood/gibs/up,
/obj/structure/stool/bed/chair/schair/wagon{
	dir = 4
	},
/obj/item/device/radio/intercom{
	name = "Station Intercom (General)";
	pixel_x = -28;
	pixel_y = -5
	},
/turf/simulated/shuttle/floor/evac/eng2,
/area/space)
"LG" = (
/obj/effect/decal/cleanable/blood/drip,
/obj/structure/door_assembly/door_assembly_hatch,
/obj/effect/decal/cleanable/dirt,
/turf/simulated/floor/engine/cult/lava,
/area/space)
"LM" = (
/obj/machinery/mech_bay_recharge_port{
	dir = 1
	},
/turf/simulated/floor/engine/cult,
/area/space)
"Mz" = (
/obj/structure/cult/anomaly/shell,
/turf/simulated/floor/engine/cult,
/area/space)
"Nk" = (
/obj/effect/landmark/corpse/clown,
/obj/item/weapon/reagent_containers/food/snacks/grown/banana/honk,
/obj/structure/sign/poster/contraband/clown{
	pixel_y = 32
	},
/obj/machinery/light_construct/small{
	dir = 1
	},
/turf/simulated/floor/engine/cult/lava,
/area/space)
"ND" = (
/obj/item/weapon/kitchenknife/ritual,
/obj/effect/decal/cleanable/dirt,
/turf/simulated/floor/engine/cult/lava,
/area/space)
"NP" = (
/turf/environment/space,
/area/space)
"Oe" = (
/obj/structure/cult/statue/camera/gargoyle,
/turf/simulated/floor/engine/cult/lava,
/area/space)
"OI" = (
/obj/structure/object_wall/standart{
	dir = 4;
	icon_state = "diagonalWall3"
	},
/turf/environment/space,
/area/space)
"Ph" = (
/obj/structure/stool/bed/chair/schair/wagon{
	dir = 4
	},
/obj/machinery/power/apc/largecell{
	dir = 8;
	name = "largecell apc left";
	pixel_x = -28
	},
/obj/structure/cable{
	d2 = 2;
	icon_state = "0-2"
	},
/turf/simulated/floor/engine/cult,
/area/space)
"PH" = (
/obj/effect/decal/cleanable/blood/drip,
/obj/effect/decal/cleanable/dirt,
/turf/simulated/floor/engine/cult/lava,
/area/space)
"PO" = (
/obj/effect/decal/remains/human,
/turf/simulated/shuttle/floor/evac/eng2,
/area/space)
"Qa" = (
/obj/structure/mineral_door/cult,
/turf/simulated/shuttle/floor/evac/eng1,
/area/space)
"Qd" = (
/obj/effect/decal/cleanable/blood/gibs,
/obj/effect/decal/cleanable/dirt,
/turf/simulated/floor/engine/cult/lava,
/area/space)
"QT" = (
/obj/item/weapon/book/manual/wiki/cult,
/obj/effect/decal/cleanable/dirt,
/turf/simulated/floor/engine/cult,
/area/space)
"Ry" = (
/obj/effect/decal/cleanable/blood/drip,
/mob/living/simple_animal/hostile/cellular/meat/maniac,
/obj/item/clothing/suit/necromancer_hoodie,
/turf/simulated/floor/engine/cult,
/area/space)
"RF" = (
/obj/structure/cult/anomaly/orb,
/turf/simulated/floor/engine/cult/lava,
/area/space)
"RG" = (
/obj/item/weapon/bananapeel,
/obj/effect/decal/cleanable/dirt,
/turf/simulated/floor/engine/cult,
/area/space)
"Sb" = (
/obj/structure/pedestal/cult,
/obj/structure/extinguisher_cabinet{
	pixel_y = -30
	},
/turf/simulated/floor/engine/cult/lava,
/area/space)
"SD" = (
/obj/machinery/portable_atmospherics/canister/air,
/turf/simulated/floor/engine/cult,
/area/space)
"SP" = (
/obj/machinery/portable_atmospherics/canister/air,
/obj/structure/cable{
	d1 = 1;
	d2 = 2;
	icon_state = "1-2"
	},
/obj/effect/decal/cleanable/dirt,
/turf/simulated/shuttle/floor/evac/eng2,
/area/space)
"TK" = (
/obj/structure/cult/anomaly/timewhole,
/obj/machinery/power/terminal,
/obj/structure/cable{
	d2 = 4;
	icon_state = "0-4"
	},
/obj/effect/decal/cleanable/dirt,
/turf/simulated/shuttle/floor/evac/eng2,
/area/space)
"UI" = (
/obj/effect/decal/cleanable/blood,
/obj/structure/cable{
	d1 = 2;
	d2 = 8;
	icon_state = "2-8"
	},
/turf/simulated/floor/engine/cult/lava,
/area/space)
"UJ" = (
/obj/machinery/optable/torture_table,
/turf/simulated/floor/engine/cult/lava,
/area/space)
"VH" = (
/obj/structure/altar_of_gods/cult,
/obj/item/weapon/reagent_containers/food/snacks/grown/banana{
	pixel_y = 8
	},
/obj/item/weapon/reagent_containers/food/snacks/grown/banana,
/obj/item/device/radio/intercom{
	name = "Station Intercom (General)";
	pixel_y = -32
	},
/obj/effect/decal/cleanable/dirt,
/turf/simulated/floor/engine/cult/lava,
/area/space)
"WW" = (
/obj/structure/cult/statue/camera/jew,
/turf/simulated/floor/engine/cult/lava,
/area/space)
"Xm" = (
/obj/structure/cult/anomaly/orb,
/turf/environment/space,
/area/space)
"XH" = (
/obj/machinery/portable_atmospherics/canister/air,
/obj/structure/cable{
	d1 = 1;
	d2 = 4;
	icon_state = "1-4"
	},
/obj/effect/decal/cleanable/dirt,
/turf/simulated/floor/engine/cult/lava,
/area/space)
"XP" = (
/obj/machinery/power/smes,
/obj/structure/cable{
	d2 = 8;
	icon_state = "0-8"
	},
/obj/machinery/light/small{
	brightness_color = "#008000"
	},
/turf/simulated/shuttle/floor/evac/eng2,
/area/space)
"YJ" = (
/obj/machinery/power/port_gen/riteg,
/obj/structure/cable,
/turf/simulated/floor/engine/cult,
/area/space)
"YT" = (
/obj/structure/cult/anomaly/spacewhole,
/turf/environment/space,
/area/space)
"ZB" = (
/obj/item/weapon/ore/glass,
/turf/environment/space,
/area/space)

(1,1,1) = {"
NP
ay
NP
NP
NP
NP
NP
NP
NP
NP
NP
NP
NP
NP
NP
NP
NP
"}
(2,1,1) = {"
NP
aT
ej
gZ
jo
qV
NP
NP
NP
NP
HN
aT
ej
gZ
jo
qV
NP
"}
(3,1,1) = {"
NP
aV
eD
eD
lJ
by
ej
gZ
gZ
gZ
jo
by
eD
lJ
eD
by
NP
"}
(4,1,1) = {"
aa
bc
fE
hp
bc
aV
lJ
eD
lJ
eD
eD
aV
by
SD
SD
aV
YT
"}
(5,1,1) = {"
NP
by
fV
hD
lY
rK
vb
wR
by
FK
Ia
LA
Ph
SP
XH
bc
NP
"}
(6,1,1) = {"
NP
bQ
gk
hU
mM
sd
vh
xd
wv
fV
IG
LG
PH
TK
XP
aV
NP
"}
(7,1,1) = {"
NP
by
gl
ih
mM
sq
vR
xK
aV
FL
JA
LM
PO
UI
YJ
by
NP
"}
(8,1,1) = {"
NP
aV
by
by
mS
bc
aV
by
aV
bc
bc
aV
Qa
aV
aV
by
ZB
"}
(9,1,1) = {"
NP
bV
by
iU
oy
sG
wd
yh
aV
FW
JG
DY
Qd
UJ
aV
OI
NP
"}
(10,1,1) = {"
NP
NP
aV
ja
fV
sM
sq
yX
bc
FX
Kf
Mz
QT
VH
bc
NP
NP
"}
(11,1,1) = {"
NP
NP
bc
jh
oH
tq
by
bc
bc
aV
bc
Nk
Ry
WW
bc
NP
NP
"}
(12,1,1) = {"
NP
NP
aV
aV
oM
tJ
by
zi
AA
Gy
aV
ND
RF
aV
aV
NP
NP
"}
(13,1,1) = {"
NP
cf
bV
by
pe
uJ
wv
xd
Ca
mM
mS
lY
RG
bc
aV
NP
NP
"}
(14,1,1) = {"
NP
NP
NP
aV
pq
uT
by
zj
Dr
GP
aV
Oe
Sb
aV
NP
NP
NP
"}
(15,1,1) = {"
NP
NP
NP
by
by
bc
aV
by
DY
by
aV
bc
bc
aV
NP
NP
NP
"}
(16,1,1) = {"
NP
NP
NP
bV
by
aV
wy
zO
EH
Ha
Kr
aV
by
OI
NP
NP
NP
"}
(17,1,1) = {"
NP
NP
NP
NP
by
by
wL
zS
EN
Hg
KA
bc
bc
Xm
NP
NP
NP
"}
(18,1,1) = {"
NP
NP
NP
NP
bV
aV
by
Af
Fe
Hy
by
by
OI
NP
NP
NP
NP
"}
(19,1,1) = {"
NP
NP
NP
NP
qK
bV
by
aV
bc
aV
aV
OI
NP
NP
NP
NP
NP
"}
(20,1,1) = {"
NP
NP
NP
NP
NP
NP
NP
NP
NP
ay
NP
NP
NP
NP
NP
NP
NP
"}
