//MAP CONVERTED BY dmm2tgm.py THIS HEADER COMMENT PREVENTS RECONVERSION, DO NOT REMOVE
"ac" = (
/obj/structure/table/woodentable,
/obj/item/weapon/book/manual/wiki/barman_recipes,
/obj/machinery/light/small{
	dir = 1
	},
/turf/simulated/floor/wood,
/area/space)
"ay" = (
/obj/structure/flora/tree/jungle/small,
/turf/simulated/floor/grass,
/area/space)
"az" = (
/obj/machinery/computer/arcade,
/turf/simulated/floor/wood,
/area/space)
"aR" = (
/obj/structure/table/woodentable,
/obj/machinery/chem_dispenser/beer{
	pixel_y = 4
	},
/obj/structure/sign/velocity_overlay/reklama{
	name = "\improper It's in the Hat!";
	pixel_y = 32
	},
/turf/simulated/floor/wood,
/area/space)
"aS" = (
/obj/machinery/light/small,
/turf/simulated/floor/wood{
	icon_state = "wood-broken3"
	},
/area/space)
"bX" = (
/obj/structure/drain{
	drainage = 2
	},
/obj/machinery/shower/free{
	pixel_y = 24
	},
/turf/simulated/floor{
	icon_state = "freezerfloor"
	},
/area/space)
"ct" = (
/obj/structure/flora/ausbushes/sparsegrass{
	layer = 2.7
	},
/obj/structure/flora/tree/jungle/small,
/turf/simulated/floor/grass,
/area/space)
"cB" = (
/turf/simulated/floor/carpet/green,
/area/space)
"dh" = (
/obj/structure/flora/ausbushes/pointybush,
/turf/simulated/floor/grass,
/area/space)
"dw" = (
/obj/structure/easel,
/turf/simulated/floor/wood{
	icon_state = "wood-broken5"
	},
/area/space)
"dy" = (
/obj/structure/stool/bed,
/turf/simulated/floor/wood,
/area/space)
"eo" = (
/turf/simulated/floor/carpet,
/area/space)
"ev" = (
/obj/structure/flora/ausbushes/sparsegrass{
	layer = 2.7
	},
/turf/simulated/floor/beach/sand,
/area/space)
"eG" = (
/obj/machinery/hydroponics/soil,
/turf/simulated/floor/grass,
/area/space)
"fm" = (
/obj/structure/table/woodentable,
/obj/item/weapon/reagent_containers/food/drinks/shaker{
	pixel_x = -7;
	pixel_y = 11
	},
/obj/item/weapon/reagent_containers/glass/rag{
	pixel_x = 6
	},
/turf/simulated/floor/wood,
/area/space)
"fq" = (
/turf/simulated/mineral,
/area/space)
"fZ" = (
/obj/structure/flora/ausbushes/fullgrass{
	layer = 2.7
	},
/turf/simulated/floor/grass,
/area/space)
"gc" = (
/turf/simulated/floor/wood{
	icon_state = "wood_stairs2"
	},
/area/space)
"hq" = (
/obj/machinery/light{
	dir = 1
	},
/obj/structure/flora/ausbushes/fullgrass{
	layer = 2.7
	},
/turf/simulated/floor/grass,
/area/space)
"hu" = (
/obj/structure/table/woodentable,
/obj/item/device/camera_film{
	pixel_x = -3;
	pixel_y = 1
	},
/obj/machinery/light/small{
	dir = 8
	},
/turf/simulated/floor/wood,
/area/space)
"hZ" = (
/obj/structure/stool/bed/chair/comfy/brown{
	dir = 8
	},
/turf/simulated/floor/wood{
	icon_state = "wood-broken3"
	},
/area/space)
"ir" = (
/obj/machinery/atmospherics/pipe/simple/visible{
	dir = 9
	},
/turf/simulated/floor/plating,
/area/space)
"iJ" = (
/obj/machinery/door/airlock/external{
	frequency = 1379;
	id_tag = "asteroidder_inner";
	locked = 1
	},
/obj/machinery/atmospherics/pipe/simple/visible{
	dir = 4
	},
/turf/simulated/floor/plating{
	dir = 4;
	icon_state = "warnplate"
	},
/area/space)
"iZ" = (
/obj/structure/flora/ausbushes/fullgrass{
	layer = 2.7
	},
/turf/simulated/floor/beach/sand,
/area/space)
"jT" = (
/obj/structure/grille,
/obj/structure/window/reinforced{
	dir = 8
	},
/obj/structure/window/reinforced{
	dir = 1
	},
/obj/structure/window/reinforced,
/obj/machinery/door/firedoor,
/turf/simulated/floor/plating,
/area/space)
"kf" = (
/obj/structure/table/woodentable/poker,
/obj/item/weapon/storage/pill_bottle/dice,
/obj/machinery/computer/security/telescreen/entertainment{
	pixel_x = 32
	},
/turf/simulated/floor/wood{
	icon_state = "wood-broken4"
	},
/area/space)
"kN" = (
/obj/structure/easel,
/obj/machinery/light/small{
	dir = 1
	},
/turf/simulated/floor/wood,
/area/space)
"lE" = (
/obj/machinery/atmospherics/components/unary/vent_pump/on{
	dir = 8
	},
/turf/simulated/floor/plating{
	icon_state = "platebotc"
	},
/area/space)
"lG" = (
/obj/structure/table/woodentable,
/obj/item/weapon/storage/fancy/crayons{
	pixel_y = 5
	},
/turf/simulated/floor/wood,
/area/space)
"lQ" = (
/obj/machinery/light/small{
	dir = 4
	},
/turf/simulated/floor/wood{
	dir = 6;
	icon_state = "wood_stairs2"
	},
/area/space)
"me" = (
/obj/item/weapon/flora/random,
/turf/simulated/floor/wood{
	icon_state = "wood-broken5"
	},
/area/space)
"mD" = (
/obj/machinery/light{
	dir = 8
	},
/turf/simulated/floor/beach/sand,
/area/space)
"mK" = (
/obj/structure/flora/ausbushes/fullgrass{
	layer = 2.7
	},
/obj/structure/flora/tree/jungle,
/obj/machinery/light{
	dir = 8
	},
/turf/simulated/floor/grass,
/area/space)
"nf" = (
/obj/structure/device/piano/minimoog,
/turf/simulated/floor/wood,
/area/space)
"ng" = (
/obj/structure/closet/secure_closet/personal/cabinet,
/obj/item/clothing/suit/plaid,
/turf/simulated/floor/wood{
	icon_state = "wood-broken"
	},
/area/space)
"no" = (
/obj/structure/stool/bed/chair/comfy/brown,
/turf/simulated/floor/wood,
/area/space)
"nD" = (
/obj/structure/flora/tree/jungle,
/turf/simulated/floor/grass,
/area/space)
"nK" = (
/obj/machinery/light,
/turf/simulated/floor/beach/water,
/area/space)
"nO" = (
/turf/unsimulated/wall/log,
/area/space)
"oa" = (
/obj/machinery/atmospherics/components/unary/tank/air{
	dir = 4
	},
/turf/simulated/floor/plating{
	icon_state = "platebotc"
	},
/area/space)
"op" = (
/obj/structure/stool/bed/chair/comfy/brown{
	dir = 8
	},
/turf/simulated/floor/wood,
/area/space)
"ow" = (
/obj/structure/flora/ausbushes/palebush,
/turf/simulated/floor/grass,
/area/space)
"oL" = (
/obj/machinery/atmospherics/pipe/manifold/visible{
	dir = 8
	},
/turf/simulated/floor/plating,
/area/space)
"oT" = (
/obj/structure/flora/ausbushes/ywflowers{
	layer = 2.7
	},
/turf/simulated/floor/grass,
/area/space)
"qg" = (
/obj/machinery/light{
	dir = 4
	},
/turf/simulated/floor/beach/water,
/area/space)
"qp" = (
/obj/structure/table/woodentable,
/turf/simulated/floor/carpet/black,
/area/space)
"qY" = (
/obj/structure/flora/ausbushes/sparsegrass{
	layer = 2.7
	},
/obj/machinery/light{
	dir = 4
	},
/turf/simulated/floor/grass,
/area/space)
"rf" = (
/obj/machinery/washing_machine,
/turf/simulated/floor{
	icon_state = "freezerfloor"
	},
/area/space)
"ro" = (
/obj/structure/stool/bed/chair/comfy/brown{
	dir = 1
	},
/turf/simulated/floor/wood,
/area/space)
"rs" = (
/obj/structure/stool/bed/chair/comfy/brown{
	dir = 4
	},
/obj/machinery/light/small{
	dir = 1
	},
/turf/simulated/floor/wood,
/area/space)
"td" = (
/obj/machinery/atmospherics/components/unary/tank/air,
/turf/simulated/floor/plating{
	icon_state = "platebotc"
	},
/area/space)
"ti" = (
/obj/item/weapon/flora/random,
/turf/simulated/floor/wood,
/area/space)
"tA" = (
/obj/structure/flora/ausbushes/brflowers{
	layer = 2.7
	},
/turf/simulated/floor/grass,
/area/space)
"uf" = (
/turf/simulated/floor/grass,
/area/space)
"ui" = (
/obj/structure/stool/bar,
/turf/simulated/floor/carpet/black,
/area/space)
"uJ" = (
/obj/machinery/atmospherics/components/unary/portables_connector{
	dir = 4
	},
/obj/machinery/portable_atmospherics/canister/air,
/turf/simulated/floor/plating{
	icon_state = "platebotc"
	},
/area/space)
"uP" = (
/obj/structure/grille,
/obj/structure/window/reinforced{
	dir = 1
	},
/obj/structure/window/reinforced,
/obj/machinery/door/firedoor,
/turf/simulated/floor/plating,
/area/space)
"vh" = (
/obj/structure/flora/ausbushes/leafybush,
/turf/simulated/floor/grass,
/area/space)
"vF" = (
/turf/simulated/wall,
/area/space)
"vM" = (
/obj/structure/stool/bar,
/turf/simulated/floor/carpet/green,
/area/space)
"vR" = (
/obj/structure/rack,
/obj/item/clothing/under/bathtowel,
/obj/item/clothing/under/bathtowel,
/obj/item/clothing/under/bathtowel,
/obj/item/weapon/reagent_containers/food/snacks/soap/deluxe,
/obj/item/weapon/bikehorn/rubberducky{
	pixel_y = 4
	},
/obj/structure/curtain/open/shower,
/obj/structure/window/reinforced{
	dir = 8
	},
/turf/simulated/floor{
	icon_state = "freezerfloor"
	},
/area/space)
"vY" = (
/obj/structure/mineral_door/wood,
/turf/simulated/floor{
	icon_state = "freezerfloor"
	},
/area/space)
"wg" = (
/obj/structure/stool/bed/chair/comfy/brown,
/obj/machinery/light/small{
	dir = 8
	},
/turf/simulated/floor/wood,
/area/space)
"wq" = (
/obj/item/weapon/flora/random,
/obj/machinery/light/small{
	dir = 1
	},
/turf/simulated/floor/wood{
	icon_state = "wood-broken6"
	},
/area/space)
"wQ" = (
/turf/simulated/floor/beach/sand,
/area/space)
"xd" = (
/turf/simulated/floor/beach/coastline,
/area/space)
"xg" = (
/turf/simulated/floor/plating/airless{
	dir = 4;
	icon_state = "warnplatecorner"
	},
/area/space)
"xy" = (
/obj/structure/mineral_door/wood,
/turf/simulated/floor/wood,
/area/space)
"yb" = (
/turf/simulated/floor/wood{
	dir = 6;
	icon_state = "wood_stairs"
	},
/area/space)
"yf" = (
/obj/structure/flora/ausbushes/ppflowers{
	layer = 2.7
	},
/turf/simulated/floor/grass,
/area/space)
"yT" = (
/obj/structure/table/woodentable,
/obj/machinery/chem_dispenser/soda{
	pixel_y = 4
	},
/obj/machinery/light/small{
	dir = 4
	},
/turf/simulated/floor/wood{
	icon_state = "wood-broken7"
	},
/area/space)
"yZ" = (
/turf/simulated/floor/carpet/black,
/area/space)
"zo" = (
/obj/structure/flora/ausbushes/stalkybush,
/turf/simulated/floor/grass,
/area/space)
"zy" = (
/obj/structure/table/woodentable,
/obj/item/painting_frame{
	pixel_y = 4
	},
/obj/item/painting_frame{
	pixel_y = -4
	},
/obj/item/stack/sheet/cloth{
	amount = 50;
	pixel_y = -11
	},
/turf/simulated/floor/wood,
/area/space)
"AB" = (
/turf/simulated/floor/wood{
	dir = 5;
	icon_state = "wood_stairs"
	},
/area/space)
"AX" = (
/obj/structure/dresser,
/turf/simulated/floor/wood,
/area/space)
"Bi" = (
/obj/structure/table/woodentable,
/obj/item/weapon/paper_bin{
	pixel_y = 4
	},
/obj/item/weapon/pen/blue{
	pixel_x = 5;
	pixel_y = 5
	},
/obj/item/weapon/pen/red{
	pixel_x = -5;
	pixel_y = 6
	},
/obj/item/weapon/pen{
	pixel_y = 6
	},
/turf/simulated/floor/wood{
	icon_state = "wood-broken3"
	},
/area/space)
"Bj" = (
/obj/structure/flora/ausbushes/sparsegrass{
	layer = 2.7
	},
/obj/machinery/hydroponics/soil,
/turf/simulated/floor/grass,
/area/space)
"By" = (
/obj/structure/closet/secure_closet/personal/cabinet,
/obj/item/clothing/suit/plaid,
/turf/simulated/floor/wood,
/area/space)
"Ch" = (
/obj/item/weapon/flora/random,
/turf/simulated/floor/beach/sand,
/area/space)
"Cn" = (
/obj/machinery/vending/boozeomat{
	req_access = list()
	},
/turf/simulated/floor/wood,
/area/space)
"Dz" = (
/obj/structure/flora/ausbushes/fernybush,
/turf/simulated/floor/grass,
/area/space)
"Ed" = (
/obj/machinery/light{
	dir = 1
	},
/obj/structure/flora/ausbushes/fullgrass{
	layer = 2.7
	},
/obj/structure/flora/ausbushes/ppflowers{
	layer = 2.7
	},
/turf/simulated/floor/grass,
/area/space)
"FB" = (
/obj/structure/flora/ausbushes/fullgrass{
	layer = 2.7
	},
/obj/structure/flora/ausbushes/lavendergrass{
	layer = 2.7
	},
/turf/simulated/floor/grass,
/area/space)
"FD" = (
/obj/structure/stool/bed,
/obj/machinery/light/small{
	dir = 4
	},
/turf/simulated/floor/wood{
	icon_state = "wood-broken7"
	},
/area/space)
"FX" = (
/obj/structure/flora/ausbushes/sparsegrass{
	layer = 2.7
	},
/obj/structure/flora/ausbushes/ywflowers{
	layer = 2.7
	},
/turf/simulated/floor/grass,
/area/space)
"Gy" = (
/turf/simulated/floor/wood{
	icon_state = "wood-broken4"
	},
/area/space)
"GE" = (
/obj/structure/table/woodentable,
/obj/item/device/camera_film{
	pixel_x = 5;
	pixel_y = 10
	},
/obj/item/device/camera/lomo,
/turf/simulated/floor/wood,
/area/space)
"GS" = (
/obj/structure/grille,
/obj/structure/window/reinforced{
	dir = 1
	},
/obj/structure/window/reinforced,
/obj/structure/window/reinforced{
	dir = 4
	},
/obj/machinery/door/firedoor,
/turf/simulated/floor/plating,
/area/space)
"Hj" = (
/obj/machinery/light/small,
/turf/simulated/floor/wood{
	dir = 5;
	icon_state = "wood_stairs2"
	},
/area/space)
"Hl" = (
/obj/structure/flora/ausbushes/sparsegrass{
	layer = 2.7
	},
/obj/structure/flora/ausbushes/ppflowers{
	layer = 2.7
	},
/obj/machinery/atmospherics/pipe/simple/visible{
	dir = 9
	},
/turf/simulated/floor/grass,
/area/space)
"Hq" = (
/obj/structure/flora/ausbushes/fullgrass{
	layer = 2.7
	},
/obj/structure/flora/ausbushes/brflowers{
	layer = 2.7
	},
/turf/simulated/floor/grass,
/area/space)
"HB" = (
/turf/simulated/floor/wood{
	dir = 6;
	icon_state = "wood_stairs2"
	},
/area/space)
"HI" = (
/obj/structure/flora/ausbushes/grassybush,
/turf/simulated/floor/grass,
/area/space)
"HW" = (
/obj/structure/table/woodentable/poker,
/obj/item/toy/cards,
/turf/simulated/floor/wood,
/area/space)
"Iq" = (
/turf/simulated/floor{
	icon_state = "freezerfloor"
	},
/area/space)
"IL" = (
/obj/item/weapon/flora/random,
/obj/machinery/light/small{
	dir = 1
	},
/turf/simulated/floor/wood,
/area/space)
"Jc" = (
/obj/structure/flora/ausbushes/sparsegrass{
	layer = 2.7
	},
/obj/item/weapon/flora/random,
/turf/simulated/floor/grass,
/area/space)
"Ji" = (
/obj/structure/flora/ausbushes/fullgrass{
	layer = 2.7
	},
/obj/item/weapon/flora/random,
/turf/simulated/floor/grass,
/area/space)
"JA" = (
/obj/structure/sink{
	dir = 8;
	pixel_x = -12
	},
/obj/structure/mirror{
	pixel_x = -28
	},
/turf/simulated/floor{
	icon_state = "freezerfloor"
	},
/area/space)
"Kb" = (
/obj/structure/flora/ausbushes/fullgrass{
	layer = 2.7
	},
/obj/structure/flora/tree/jungle,
/obj/structure/flora/ausbushes/ppflowers{
	layer = 2.7
	},
/turf/simulated/floor/grass,
/area/space)
"Kd" = (
/obj/machinery/hydroponics/soil,
/obj/item/weapon/reagent_containers/glass/bucket,
/turf/simulated/floor/grass,
/area/space)
"Kx" = (
/obj/structure/table/woodentable,
/obj/item/weapon/game_kit/random,
/turf/simulated/floor/wood{
	icon_state = "wood-broken"
	},
/area/space)
"KI" = (
/turf/simulated/floor/beach/water,
/area/space)
"KN" = (
/obj/machinery/access_button{
	command = "cycle_exterior";
	frequency = 1379;
	master_tag = "asteroidder_airlock";
	name = "exterior access button";
	pixel_x = 28
	},
/turf/simulated/floor/plating/airless{
	icon_state = "warnplatecorner"
	},
/area/space)
"Ln" = (
/obj/structure/table/woodentable,
/obj/machinery/light/small{
	dir = 1
	},
/turf/simulated/floor/wood,
/area/space)
"Lq" = (
/obj/structure/table/woodentable,
/obj/machinery/light/small{
	dir = 4
	},
/turf/simulated/floor/wood,
/area/space)
"LJ" = (
/obj/structure/stool/bar,
/obj/machinery/light/small,
/turf/simulated/floor/wood,
/area/space)
"LN" = (
/obj/machinery/atmospherics/components/unary/vent_pump/high_volume{
	frequency = 1379;
	id_tag = "asteroidder_pump"
	},
/turf/simulated/floor/plating{
	icon_state = "platebotc"
	},
/area/space)
"LV" = (
/obj/machinery/atmospherics/components/unary/vent_pump/high_volume{
	dir = 1;
	frequency = 1379;
	id_tag = "asteroidder_pump"
	},
/turf/simulated/floor/plating{
	icon_state = "platebotc"
	},
/area/space)
"Ma" = (
/obj/structure/closet/cabinet,
/obj/item/clothing/shoes/laceup,
/obj/item/clothing/under/gentlesuit,
/obj/item/clothing/suit/wcoat,
/obj/item/clothing/head/that,
/obj/item/weapon/staff/gentcane,
/turf/simulated/floor/wood,
/area/space)
"Nj" = (
/obj/structure/flora/ausbushes/fullgrass{
	layer = 2.7
	},
/obj/structure/flora/tree/jungle,
/turf/simulated/floor/grass,
/area/space)
"NE" = (
/obj/random/vending/snack,
/turf/simulated/floor/wood,
/area/space)
"NF" = (
/obj/structure/flora/ausbushes/sparsegrass{
	layer = 2.7
	},
/turf/simulated/floor/grass,
/area/space)
"NT" = (
/obj/machinery/door/airlock/external{
	frequency = 1379;
	id_tag = "asteroidder_outer";
	locked = 1
	},
/turf/simulated/floor/plating{
	dir = 8;
	icon_state = "warnplate"
	},
/area/space)
"OB" = (
/obj/structure/flora/ausbushes/fullgrass{
	layer = 2.7
	},
/obj/structure/flora/tree/jungle/small,
/turf/simulated/floor/grass,
/area/space)
"OX" = (
/obj/machinery/light{
	dir = 8
	},
/turf/simulated/floor/beach/water,
/area/space)
"Pf" = (
/obj/item/weapon/flora/random,
/turf/simulated/floor/grass,
/area/space)
"PE" = (
/obj/structure/stool/bar,
/turf/simulated/floor/wood{
	icon_state = "wood-broken6"
	},
/area/space)
"Qc" = (
/obj/machinery/light{
	dir = 4
	},
/obj/structure/flora/ausbushes/sparsegrass{
	layer = 2.7
	},
/turf/simulated/floor/beach/sand,
/area/space)
"Qf" = (
/obj/machinery/embedded_controller/radio/airlock_controller{
	id_tag = "asteroidder_airlock";
	pixel_y = 26;
	tag_airpump = "asteroidder_pump";
	tag_chamber_sensor = "asteroidder_sensor";
	tag_exterior_door = "asteroidder_outer";
	tag_interior_door = "asteroidder_inner"
	},
/obj/machinery/atmospherics/components/unary/vent_pump/high_volume{
	frequency = 1379;
	id_tag = "asteroidder_pump"
	},
/turf/simulated/floor/plating{
	icon_state = "platebotc"
	},
/area/space)
"QJ" = (
/turf/simulated/floor/wood,
/area/space)
"Rb" = (
/turf/environment/space,
/area/space)
"RR" = (
/obj/structure/flora/ausbushes/fullgrass{
	layer = 2.7
	},
/obj/structure/flora/ausbushes/ywflowers{
	layer = 2.7
	},
/turf/simulated/floor/grass,
/area/space)
"SD" = (
/obj/structure/sink/puddle,
/obj/structure/flora/ausbushes/reedbush{
	pixel_y = 6
	},
/turf/simulated/floor/grass,
/area/space)
"SG" = (
/obj/machinery/light/small{
	dir = 4
	},
/turf/simulated/floor{
	icon_state = "freezerfloor"
	},
/area/space)
"SN" = (
/obj/machinery/atmospherics/pipe/simple/visible,
/obj/machinery/light{
	dir = 8
	},
/turf/simulated/floor/grass,
/area/space)
"SP" = (
/turf/simulated/floor/plating/airless{
	dir = 4;
	icon_state = "warnplate"
	},
/area/space)
"Th" = (
/obj/structure/flora/ausbushes/genericbush,
/turf/simulated/floor/grass,
/area/space)
"Uq" = (
/obj/machinery/door/window/eastright{
	base_state = "left";
	dir = 8;
	icon_state = "left";
	name = "Shower"
	},
/obj/structure/curtain/open/shower,
/turf/simulated/floor{
	icon_state = "freezerfloor"
	},
/area/space)
"Vg" = (
/turf/simulated/floor/carpet/red,
/area/space)
"VF" = (
/obj/structure/dryer{
	dir = 4;
	pixel_x = -6
	},
/turf/simulated/floor{
	icon_state = "freezerfloor"
	},
/area/space)
"VQ" = (
/obj/machinery/light/small{
	dir = 1
	},
/turf/simulated/floor/wood{
	dir = 4;
	icon_state = "wood_stairs2"
	},
/area/space)
"VR" = (
/obj/structure/table/woodentable,
/obj/item/toy/crayon/rainbow,
/turf/simulated/floor/wood,
/area/space)
"WG" = (
/obj/structure/flora/ausbushes/sparsegrass{
	layer = 2.7
	},
/obj/structure/flora/ausbushes/ppflowers{
	layer = 2.7
	},
/turf/simulated/floor/grass,
/area/space)
"WK" = (
/obj/item/weapon/flora/random,
/turf/simulated/floor/wood{
	icon_state = "wood-broken"
	},
/area/space)
"Xp" = (
/obj/machinery/light/small{
	dir = 8
	},
/turf/simulated/floor/wood{
	icon_state = "wood_stairs2"
	},
/area/space)
"Xx" = (
/obj/machinery/airlock_sensor{
	id_tag = "asteroidder_sensor";
	layer = 3.3;
	pixel_y = -28
	},
/obj/machinery/atmospherics/components/unary/vent_pump/high_volume{
	dir = 1;
	frequency = 1379;
	id_tag = "asteroidder_pump"
	},
/turf/simulated/floor/plating{
	icon_state = "platebotc"
	},
/area/space)
"XF" = (
/obj/structure/sign/poster/official/cohiba_robusto_ad{
	pixel_x = -32
	},
/obj/machinery/vending/cigarette,
/obj/machinery/light/small{
	dir = 8
	},
/turf/simulated/floor/wood{
	icon_state = "wood-broken5"
	},
/area/space)
"XN" = (
/obj/structure/flora/ausbushes/sparsegrass{
	layer = 2.7
	},
/obj/structure/flora/tree/jungle,
/turf/simulated/floor/grass,
/area/space)
"XQ" = (
/obj/structure/toilet{
	dir = 8
	},
/obj/machinery/light/small{
	dir = 1
	},
/turf/simulated/floor{
	icon_state = "freezerfloor"
	},
/area/space)
"XS" = (
/obj/structure/flora/ausbushes/fullgrass{
	layer = 2.7
	},
/obj/structure/flora/tree/jungle/small,
/obj/structure/flora/ausbushes/ywflowers{
	layer = 2.7
	},
/turf/simulated/floor/grass,
/area/space)
"XV" = (
/obj/structure/flora/ausbushes/sunnybush,
/turf/simulated/floor/grass,
/area/space)
"YC" = (
/obj/structure/flora/ausbushes/fullgrass{
	layer = 2.7
	},
/obj/structure/flora/ausbushes/ppflowers{
	layer = 2.7
	},
/turf/simulated/floor/grass,
/area/space)
"YF" = (
/obj/machinery/access_button{
	command = "cycle_interior";
	frequency = 1379;
	master_tag = "asteroidder_airlock";
	name = "interior access button";
	pixel_x = -28
	},
/obj/structure/flora/ausbushes/pointybush,
/obj/machinery/atmospherics/pipe/simple/visible,
/turf/simulated/floor/grass,
/area/space)
"Zf" = (
/obj/machinery/atmospherics/pipe/manifold4w/visible,
/turf/simulated/floor/plating,
/area/space)
"ZD" = (
/obj/machinery/light/small,
/turf/simulated/floor/wood,
/area/space)

(1,1,1) = {"
Rb
Rb
Rb
Rb
Rb
Rb
Rb
Rb
Rb
Rb
Rb
Rb
Rb
Rb
Rb
Rb
Rb
Rb
Rb
Rb
Rb
Rb
Rb
Rb
Rb
Rb
Rb
Rb
Rb
Rb
Rb
Rb
Rb
Rb
Rb
Rb
Rb
Rb
Rb
Rb
Rb
Rb
Rb
Rb
Rb
Rb
Rb
Rb
Rb
Rb
"}
(2,1,1) = {"
Rb
Rb
Rb
Rb
Rb
Rb
Rb
Rb
Rb
Rb
Rb
Rb
Rb
Rb
Rb
Rb
Rb
Rb
Rb
Rb
Rb
Rb
Rb
Rb
Rb
Rb
Rb
Rb
Rb
Rb
Rb
Rb
Rb
Rb
Rb
Rb
Rb
Rb
Rb
Rb
Rb
Rb
Rb
Rb
Rb
Rb
Rb
Rb
Rb
Rb
"}
(3,1,1) = {"
Rb
Rb
Rb
Rb
Rb
Rb
Rb
Rb
Rb
Rb
Rb
Rb
Rb
Rb
Rb
Rb
Rb
Rb
Rb
Rb
Rb
Rb
Rb
Rb
Rb
Rb
Rb
Rb
Rb
Rb
Rb
Rb
Rb
Rb
Rb
Rb
Rb
Rb
Rb
Rb
Rb
Rb
Rb
Rb
Rb
Rb
Rb
Rb
Rb
Rb
"}
(4,1,1) = {"
Rb
Rb
Rb
Rb
Rb
Rb
Rb
Rb
Rb
Rb
Rb
Rb
Rb
Rb
Rb
Rb
Rb
Rb
Rb
Rb
Rb
Rb
Rb
Rb
KN
SP
xg
Rb
Rb
Rb
Rb
Rb
Rb
Rb
Rb
Rb
Rb
Rb
Rb
Rb
Rb
Rb
Rb
Rb
Rb
Rb
Rb
Rb
Rb
Rb
"}
(5,1,1) = {"
Rb
Rb
Rb
Rb
Rb
Rb
Rb
Rb
Rb
Rb
Rb
Rb
Rb
Rb
Rb
Rb
Rb
Rb
fq
fq
fq
fq
fq
vF
vF
NT
vF
vF
Rb
Rb
Rb
Rb
Rb
Rb
Rb
Rb
Rb
Rb
Rb
Rb
Rb
Rb
Rb
Rb
Rb
Rb
Rb
Rb
Rb
Rb
"}
(6,1,1) = {"
Rb
Rb
Rb
Rb
Rb
Rb
Rb
Rb
Rb
Rb
Rb
fq
fq
fq
fq
fq
fq
fq
fq
fq
fq
fq
fq
vF
Qf
oL
LV
vF
fq
fq
fq
fq
Rb
Rb
Rb
Rb
Rb
Rb
Rb
Rb
Rb
Rb
Rb
Rb
Rb
Rb
Rb
Rb
Rb
Rb
"}
(7,1,1) = {"
Rb
Rb
Rb
Rb
Rb
Rb
Rb
Rb
Rb
fq
fq
fq
fq
fq
fq
fq
fq
fq
fq
vF
vF
vF
vF
vF
LN
Zf
Xx
vF
fq
fq
fq
fq
fq
fq
fq
Rb
Rb
Rb
Rb
Rb
Rb
Rb
Rb
Rb
Rb
Rb
Rb
Rb
Rb
Rb
"}
(8,1,1) = {"
Rb
Rb
Rb
Rb
Rb
Rb
Rb
fq
fq
fq
fq
fq
fq
fq
fq
fq
fq
fq
vF
vF
oa
oa
uJ
vF
vF
iJ
vF
vF
fq
fq
fq
fq
fq
fq
fq
fq
fq
fq
fq
Rb
Rb
Rb
Rb
Rb
Rb
Rb
Rb
Rb
Rb
Rb
"}
(9,1,1) = {"
Rb
Rb
Rb
Rb
Rb
Rb
fq
fq
fq
fq
fq
fq
fq
fq
fq
fq
fq
fq
vF
td
Zf
Zf
Zf
SN
YF
Hl
Jc
fq
fq
fq
fq
fq
fq
fq
fq
fq
fq
fq
fq
fq
fq
fq
Rb
Rb
Rb
Rb
Rb
Rb
Rb
Rb
"}
(10,1,1) = {"
Rb
Rb
Rb
Rb
Rb
Rb
fq
fq
fq
fq
fq
fq
fq
fq
fq
fq
fq
fq
vF
td
ir
lE
lE
RR
fZ
fZ
fZ
iZ
wQ
vF
fq
fq
fq
fq
fq
fq
fq
fq
fq
fq
fq
fq
fq
Rb
Rb
Rb
Rb
Rb
Rb
Rb
"}
(11,1,1) = {"
Rb
Rb
Rb
Rb
Rb
fq
fq
fq
fq
fq
fq
fq
fq
fq
fq
fZ
uf
fq
vF
vF
Hq
fZ
fZ
fZ
fZ
uf
NF
Hq
wQ
mD
wQ
Ch
fq
fq
fq
fq
fq
fq
fq
fq
fq
fq
fq
fq
Rb
Rb
Rb
Rb
Rb
Rb
"}
(12,1,1) = {"
Rb
Rb
Rb
Rb
Rb
fq
fq
fq
fq
fq
fq
fq
fq
Pf
fZ
RR
NF
Dz
YC
Bj
NF
uf
fZ
uf
Nj
FB
NF
fZ
iZ
wQ
wQ
wQ
wQ
fq
fq
fq
fq
fq
fq
fq
fq
fq
fq
fq
Rb
Rb
Rb
Rb
Rb
Rb
"}
(13,1,1) = {"
Rb
Rb
Rb
Rb
Rb
fq
fq
fq
fq
fq
fq
fq
NF
NF
fZ
uf
XN
fZ
fZ
FB
fZ
fZ
fZ
NF
eG
fZ
uf
XS
wQ
wQ
wQ
wQ
wQ
wQ
fq
vF
fq
KI
KI
fq
fq
fq
fq
fq
fq
Rb
Rb
Rb
Rb
Rb
"}
(14,1,1) = {"
Rb
Rb
Rb
Rb
fq
fq
fq
fq
fq
fq
fq
fq
vh
fZ
fZ
fZ
fZ
fZ
NF
NF
Nj
HI
YC
fZ
fZ
fZ
fZ
fZ
fZ
iZ
wQ
wQ
wQ
wQ
xd
OX
KI
KI
KI
KI
KI
fq
fq
fq
fq
Rb
Rb
Rb
Rb
Rb
"}
(15,1,1) = {"
Rb
Rb
Rb
Rb
fq
fq
fq
fq
fq
fq
fq
NF
ct
fZ
WG
NF
tA
fZ
uf
fZ
RR
NF
fZ
OB
tA
fZ
fZ
Th
uf
wQ
wQ
wQ
wQ
wQ
xd
KI
KI
KI
KI
KI
KI
KI
fq
fq
fq
fq
Rb
Rb
Rb
Rb
"}
(16,1,1) = {"
Rb
Rb
Rb
Rb
fq
fq
fq
fq
fq
fq
fq
uf
fZ
fZ
nO
nO
nO
nO
nO
Ji
XV
qY
fZ
fZ
fZ
fZ
FB
fZ
fZ
wQ
wQ
wQ
wQ
wQ
xd
KI
KI
KI
KI
KI
KI
nK
vF
fq
fq
fq
Rb
Rb
Rb
Rb
"}
(17,1,1) = {"
Rb
Rb
Rb
Rb
fq
fq
fq
fq
fq
fq
fq
fq
FB
nO
nO
me
wg
HW
nO
nO
nO
nO
nO
uf
NF
uf
Nj
Kd
YC
iZ
wQ
wQ
wQ
wQ
xd
KI
KI
KI
KI
KI
KI
KI
KI
fq
fq
fq
fq
Rb
Rb
Rb
"}
(18,1,1) = {"
Rb
Rb
Rb
Rb
fq
fq
fq
fq
fq
fq
fq
fq
fZ
nO
az
vM
cB
hZ
nO
zy
hu
GE
nO
nO
fZ
fZ
fZ
fZ
fZ
iZ
wQ
wQ
wQ
wQ
xd
KI
KI
KI
KI
KI
KI
KI
KI
fq
fq
fq
fq
Rb
Rb
Rb
"}
(19,1,1) = {"
Rb
Rb
Rb
Rb
fq
fq
fq
fq
fq
fq
fq
fq
uf
nO
rs
cB
cB
QJ
xy
Gy
Vg
Vg
lG
jT
RR
ow
NF
uf
fZ
uf
wQ
wQ
wQ
wQ
xd
KI
KI
KI
KI
KI
KI
KI
KI
KI
fq
fq
fq
Rb
Rb
Rb
"}
(20,1,1) = {"
Rb
Rb
Rb
Rb
fq
fq
fq
fq
fq
fq
fq
NF
fZ
nO
kf
ro
QJ
Kx
nO
kN
Vg
Vg
Bi
uP
fZ
fZ
NF
fZ
OB
fZ
iZ
wQ
wQ
wQ
xd
KI
KI
KI
KI
KI
KI
KI
KI
KI
fq
fq
fq
fq
Rb
Rb
"}
(21,1,1) = {"
Rb
Rb
Rb
Rb
fq
fq
fq
fq
fq
fq
uf
fZ
yf
nO
nO
nO
xy
nO
nO
dw
Vg
Vg
VR
GS
Ji
fZ
zo
fZ
uf
NF
wQ
wQ
wQ
wQ
xd
KI
KI
KI
KI
KI
KI
KI
KI
KI
fq
fq
fq
fq
Rb
Rb
"}
(22,1,1) = {"
Rb
Rb
Rb
Rb
fq
fq
fq
fq
fq
fq
tA
fZ
nO
nO
NE
XF
QJ
nf
nO
nO
xy
nO
nO
nO
nO
Ed
fZ
fZ
fZ
FB
wQ
wQ
wQ
wQ
xd
KI
KI
KI
KI
KI
KI
KI
KI
fq
fq
fq
fq
fq
fq
Rb
"}
(23,1,1) = {"
Rb
Rb
Rb
fq
fq
fq
fq
fq
fq
fq
fZ
fZ
nO
IL
yZ
yZ
yZ
LJ
nO
WK
QJ
ZD
nO
ti
gc
fZ
uf
fZ
tA
wQ
wQ
wQ
wQ
wQ
xd
KI
KI
KI
KI
KI
KI
KI
KI
fq
fq
fq
fq
fq
fq
Rb
"}
(24,1,1) = {"
Rb
Rb
Rb
fq
fq
fq
fq
fq
fq
fq
NF
fZ
nO
PE
ui
ui
yZ
Gy
xy
eo
eo
eo
xy
QJ
yb
fZ
NF
fZ
fZ
iZ
wQ
wQ
wQ
wQ
xd
KI
KI
KI
KI
KI
KI
KI
KI
fq
fq
fq
fq
fq
fq
Rb
"}
(25,1,1) = {"
Rb
Rb
Rb
fq
fq
fq
fq
fq
fq
fq
FX
uf
nO
fm
qp
qp
yZ
QJ
xy
eo
eo
eo
xy
QJ
yb
uf
NF
oT
fZ
wQ
wQ
wQ
wQ
wQ
xd
KI
KI
KI
KI
KI
KI
KI
nK
vF
fq
fq
fq
fq
fq
Rb
"}
(26,1,1) = {"
Rb
Rb
Rb
fq
fq
fq
fq
fq
fq
fq
fq
fZ
nO
ac
yZ
yZ
yZ
aS
nO
ti
QJ
aS
nO
ti
HB
fZ
fZ
fZ
fZ
wQ
wQ
wQ
wQ
wQ
xd
KI
KI
KI
KI
KI
KI
KI
KI
KI
fq
fq
fq
fq
fq
Rb
"}
(27,1,1) = {"
Rb
Rb
Rb
fq
fq
fq
fq
fq
fq
fq
fq
FB
nO
nO
aR
yT
Cn
Ma
nO
nO
xy
nO
nO
nO
nO
hq
uf
ay
fZ
NF
ev
wQ
wQ
wQ
xd
KI
KI
KI
KI
KI
KI
KI
KI
KI
KI
fq
fq
fq
fq
Rb
"}
(28,1,1) = {"
Rb
Rb
Rb
fq
fq
fq
fq
fq
fq
fq
fq
fZ
dh
nO
nO
nO
nO
nO
nO
AX
cB
cB
ng
jT
Pf
fZ
FB
fZ
fZ
NF
wQ
wQ
wQ
wQ
xd
KI
KI
KI
KI
KI
KI
KI
KI
KI
KI
fq
fq
fq
fq
Rb
"}
(29,1,1) = {"
Rb
Rb
Rb
fq
fq
fq
fq
fq
fq
fq
fq
NF
NF
nO
rf
VF
JA
JA
nO
wq
cB
cB
By
uP
fZ
fZ
nD
fZ
vh
eG
wQ
wQ
wQ
wQ
xd
KI
KI
KI
KI
KI
KI
KI
KI
KI
KI
fq
fq
fq
fq
Rb
"}
(30,1,1) = {"
Rb
Rb
Rb
fq
fq
fq
fq
fq
fq
fq
fq
yf
fZ
nO
rf
Iq
SG
Iq
vY
QJ
cB
cB
By
GS
fZ
fZ
fZ
fZ
YC
fZ
wQ
wQ
wQ
wQ
xd
KI
KI
KI
KI
KI
KI
KI
KI
KI
KI
fq
fq
fq
Rb
Rb
"}
(31,1,1) = {"
Rb
Rb
Rb
fq
fq
fq
fq
fq
fq
fq
fq
fq
fZ
nO
vR
Uq
nO
vY
nO
dy
FD
dy
nO
nO
fZ
uf
fZ
fZ
nD
wQ
wQ
wQ
wQ
wQ
xd
KI
KI
KI
KI
KI
KI
KI
KI
KI
KI
fq
fq
fq
Rb
Rb
"}
(32,1,1) = {"
Rb
Rb
Rb
fq
fq
fq
fq
fq
fq
fq
fq
fq
NF
nO
nO
bX
nO
XQ
nO
nO
nO
nO
nO
NF
NF
fZ
uf
fZ
fZ
wQ
wQ
wQ
wQ
wQ
xd
KI
KI
KI
KI
KI
KI
KI
KI
KI
KI
fq
fq
fq
Rb
Rb
"}
(33,1,1) = {"
Rb
Rb
Rb
fq
fq
fq
fq
fq
fq
fq
fq
fq
uf
FB
nO
nO
nO
nO
nO
NF
NF
mK
ow
WG
eG
fZ
NF
tA
fZ
ev
wQ
wQ
wQ
wQ
xd
KI
KI
KI
KI
KI
KI
KI
KI
nK
vF
fq
fq
fq
Rb
Rb
"}
(34,1,1) = {"
Rb
Rb
Rb
Rb
fq
fq
fq
fq
fq
fq
fq
fq
fq
fZ
uf
fZ
Th
tA
fZ
uf
NF
fZ
fZ
fZ
fZ
fZ
OB
fZ
fZ
wQ
wQ
wQ
wQ
wQ
xd
KI
KI
KI
KI
KI
KI
KI
KI
KI
fq
fq
fq
fq
Rb
Rb
"}
(35,1,1) = {"
Rb
Rb
Rb
Rb
fq
fq
fq
fq
fq
fq
fq
fq
fq
fZ
Kb
fZ
fZ
fZ
fZ
fZ
fZ
RR
uf
fZ
FB
uf
fZ
SD
fZ
iZ
wQ
wQ
wQ
wQ
xd
KI
KI
KI
KI
KI
KI
KI
KI
KI
fq
fq
fq
fq
Rb
Rb
"}
(36,1,1) = {"
Rb
Rb
Rb
Rb
fq
fq
fq
fq
fq
fq
fq
fq
fq
uf
fZ
NF
NF
OB
Bj
HI
vF
VQ
AB
Hj
vF
Ji
uf
NF
fZ
wQ
wQ
wQ
wQ
wQ
xd
KI
KI
KI
KI
KI
KI
KI
KI
fq
fq
fq
fq
fq
Rb
Rb
"}
(37,1,1) = {"
Rb
Rb
Rb
Rb
Rb
fq
fq
fq
fq
fq
fq
fq
fZ
fZ
fZ
fZ
uf
fZ
YC
vF
vF
QJ
QJ
QJ
vF
vF
fZ
YC
fZ
uf
wQ
wQ
wQ
wQ
xd
KI
KI
KI
KI
KI
KI
fq
fq
fq
fq
fq
fq
fq
Rb
Rb
"}
(38,1,1) = {"
Rb
Rb
Rb
Rb
Rb
fq
fq
fq
fq
fq
fq
fq
fZ
ct
RR
fZ
fZ
fZ
Nj
vF
no
yZ
yZ
yZ
QJ
Xp
fZ
Dz
fZ
RR
iZ
wQ
wQ
wQ
xd
KI
KI
KI
KI
KI
KI
fq
fq
fq
fq
fq
fq
Rb
Rb
Rb
"}
(39,1,1) = {"
Rb
Rb
Rb
Rb
Rb
fq
fq
fq
fq
fq
fq
fq
fq
uf
fZ
NF
uf
fZ
tA
vF
Ln
yZ
yZ
yZ
QJ
yb
fZ
NF
fZ
uf
wQ
wQ
wQ
Ch
fq
fq
fq
KI
qg
KI
fq
fq
fq
fq
fq
fq
fq
Rb
Rb
Rb
"}
(40,1,1) = {"
Rb
Rb
Rb
Rb
Rb
Rb
fq
fq
fq
fq
fq
fq
fq
fq
fq
fq
NF
FB
fZ
vF
no
yZ
yZ
yZ
QJ
lQ
fZ
FB
fZ
wQ
wQ
wQ
wQ
fq
fq
fq
fq
fq
vF
fq
fq
fq
fq
fq
fq
fq
fq
Rb
Rb
Rb
"}
(41,1,1) = {"
Rb
Rb
Rb
Rb
Rb
Rb
Rb
fq
fq
fq
fq
fq
fq
fq
fq
fq
fq
NF
XV
vF
vF
op
Lq
op
vF
vF
Ji
Qc
wQ
wQ
wQ
wQ
wQ
fq
fq
fq
fq
fq
fq
fq
fq
fq
fq
fq
fq
fq
Rb
Rb
Rb
Rb
"}
(42,1,1) = {"
Rb
Rb
Rb
Rb
Rb
Rb
Rb
fq
fq
fq
fq
fq
fq
fq
fq
fq
fq
fq
fq
fq
vF
vF
vF
vF
vF
fq
fq
vF
fq
wQ
wQ
Ch
fq
fq
fq
fq
fq
fq
fq
fq
fq
fq
fq
fq
fq
fq
Rb
Rb
Rb
Rb
"}
(43,1,1) = {"
Rb
Rb
Rb
Rb
Rb
Rb
Rb
Rb
fq
fq
fq
fq
fq
fq
fq
fq
fq
fq
fq
fq
fq
fq
fq
fq
fq
fq
fq
fq
fq
fq
fq
fq
fq
fq
fq
fq
fq
fq
fq
fq
fq
fq
fq
fq
fq
fq
Rb
Rb
Rb
Rb
"}
(44,1,1) = {"
Rb
Rb
Rb
Rb
Rb
Rb
Rb
Rb
Rb
fq
fq
fq
fq
fq
fq
fq
fq
fq
fq
fq
fq
fq
fq
fq
fq
fq
fq
fq
fq
fq
fq
fq
fq
fq
fq
fq
fq
fq
fq
fq
fq
fq
fq
fq
fq
Rb
Rb
Rb
Rb
Rb
"}
(45,1,1) = {"
Rb
Rb
Rb
Rb
Rb
Rb
Rb
Rb
Rb
Rb
fq
fq
fq
fq
fq
fq
fq
fq
fq
fq
fq
fq
fq
fq
fq
fq
fq
fq
fq
fq
fq
fq
fq
fq
fq
fq
fq
fq
fq
fq
fq
fq
fq
fq
fq
Rb
Rb
Rb
Rb
Rb
"}
(46,1,1) = {"
Rb
Rb
Rb
Rb
Rb
Rb
Rb
Rb
Rb
Rb
Rb
Rb
fq
fq
fq
fq
fq
fq
fq
fq
fq
fq
fq
fq
fq
fq
fq
fq
fq
fq
fq
fq
fq
fq
fq
fq
fq
fq
fq
fq
fq
fq
fq
fq
Rb
Rb
Rb
Rb
Rb
Rb
"}
(47,1,1) = {"
Rb
Rb
Rb
Rb
Rb
Rb
Rb
Rb
Rb
Rb
Rb
Rb
Rb
Rb
fq
fq
fq
fq
fq
fq
fq
fq
fq
fq
fq
fq
fq
fq
fq
fq
fq
fq
fq
fq
fq
fq
fq
fq
fq
fq
fq
fq
fq
Rb
Rb
Rb
Rb
Rb
Rb
Rb
"}
(48,1,1) = {"
Rb
Rb
Rb
Rb
Rb
Rb
Rb
Rb
Rb
Rb
Rb
Rb
Rb
Rb
Rb
Rb
Rb
fq
fq
fq
fq
fq
fq
fq
fq
fq
fq
fq
fq
fq
fq
fq
fq
fq
fq
fq
fq
fq
Rb
Rb
Rb
Rb
Rb
Rb
Rb
Rb
Rb
Rb
Rb
Rb
"}
(49,1,1) = {"
Rb
Rb
Rb
Rb
Rb
Rb
Rb
Rb
Rb
Rb
Rb
Rb
Rb
Rb
Rb
Rb
Rb
Rb
Rb
Rb
Rb
Rb
Rb
Rb
fq
fq
fq
fq
fq
fq
fq
fq
fq
fq
fq
Rb
Rb
Rb
Rb
Rb
Rb
Rb
Rb
Rb
Rb
Rb
Rb
Rb
Rb
Rb
"}
(50,1,1) = {"
Rb
Rb
Rb
Rb
Rb
Rb
Rb
Rb
Rb
Rb
Rb
Rb
Rb
Rb
Rb
Rb
Rb
Rb
Rb
Rb
Rb
Rb
Rb
Rb
Rb
Rb
Rb
Rb
Rb
Rb
Rb
Rb
Rb
Rb
Rb
Rb
Rb
Rb
Rb
Rb
Rb
Rb
Rb
Rb
Rb
Rb
Rb
Rb
Rb
Rb
"}
