//MAP CONVERTED BY dmm2tgm.py THIS HEADER COMMENT PREVENTS RECONVERSION, DO NOT REMOVE
"aa" = (
/turf/space,
/area/space)
"ab" = (
/turf/simulated/shuttle/wall{
	icon_state = "swall_f9"
	},
/area/space)
"ac" = (
/turf/simulated/shuttle/wall{
	icon_state = "swall12"
	},
/area/space)
"ae" = (
/turf/simulated/shuttle/wall{
	icon_state = "swall3"
	},
/area/space)
"af" = (
/turf/simulated/shuttle/wall{
	icon_state = "swall_f10"
	},
/area/space)
"ag" = (
/obj/machinery/chem_dispenser,
/turf/simulated/floor{
	icon_state = "white"
	},
/area/space)
"ah" = (
/obj/machinery/door/airlock/virology/glass{
	name = "Isolation B";
	req_access = list(39)
	},
/turf/simulated/floor{
	icon_state = "white"
	},
/area/space)
"ai" = (
/obj/structure/table/glass,
/obj/item/weapon/paper{
	info = "Information about the virus from the planet Omicron-8. The virus behaves unpredictably. Five weeks ago, when you delivered it to us, it was calm, and caused only cough and a little nausea. A week later, the virus caused bloody vomiting and severe epilepsy. Two weeks after delivery, it caused strong aggression, and was transmitted not through airborne droplets, but through blood and saliva.";
	name = "Report #1"
	},
/turf/simulated/floor{
	icon_state = "white"
	},
/area/space)
"aj" = (
/obj/structure/table/glass,
/obj/structure/reagent_dispensers/virusfood{
	pixel_y = 30
	},
/turf/simulated/floor{
	icon_state = "white"
	},
/area/space)
"ak" = (
/obj/structure/table/glass,
/obj/machinery/light{
	dir = 8
	},
/turf/simulated/floor{
	icon_state = "white"
	},
/area/space)
"al" = (
/obj/structure/table/glass,
/obj/item/weapon/reagent_containers/glass/beaker/large,
/turf/simulated/floor{
	icon_state = "white"
	},
/area/space)
"am" = (
/obj/effect/decal/cleanable/blood,
/obj/effect/landmark/corpse/doctor,
/turf/simulated/floor{
	icon_state = "white"
	},
/area/space)
"an" = (
/obj/item/weapon/pen,
/turf/simulated/floor{
	icon_state = "white"
	},
/area/space)
"ao" = (
/obj/item/weapon/paper{
	info = "The preliminary name of the virus is PAX-12. 6 weeks after delivery, the infected began to attack the medical staff and security officers. Some infected are trying to get out of isolation cells.";
	name = "Report #2"
	},
/turf/simulated/floor{
	icon_state = "white"
	},
/area/space)
"ap" = (
/obj/structure/table/glass,
/obj/item/weapon/reagent_containers/glass/beaker/bluespace,
/turf/simulated/floor{
	icon_state = "white"
	},
/area/space)
"aq" = (
/obj/structure/table/glass,
/obj/machinery/light{
	dir = 4
	},
/turf/simulated/floor{
	icon_state = "white"
	},
/area/space)
"ar" = (
/turf/simulated/floor{
	icon_state = "white"
	},
/area/space)
"as" = (
/turf/simulated/shuttle/wall,
/area/space)
"at" = (
/obj/effect/decal/cleanable/blood,
/turf/simulated/floor{
	icon_state = "white"
	},
/area/space)
"au" = (
/obj/structure/table/glass,
/obj/item/weapon/reagent_containers/spray/cleaner,
/turf/simulated/floor{
	icon_state = "white"
	},
/area/space)
"av" = (
/obj/structure/table/glass,
/obj/item/weapon/paper_bin,
/obj/item/weapon/pen,
/turf/simulated/floor{
	icon_state = "white"
	},
/area/space)
"aw" = (
/obj/structure/table/glass,
/obj/item/weapon/disk/research_points,
/turf/simulated/floor{
	icon_state = "white"
	},
/area/space)
"ax" = (
/turf/simulated/shuttle/wall{
	icon_state = "swall_s10"
	},
/area/space)
"ay" = (
/obj/structure/closet/emcloset,
/turf/simulated/floor{
	icon_state = "white"
	},
/area/space)
"az" = (
/obj/item/clothing/shoes/combat,
/obj/effect/decal/cleanable/blood,
/obj/item/ammo_casing/c9mm,
/obj/item/ammo_casing/c9mm,
/obj/item/clothing/under/ert,
/obj/effect/decal/remains/human,
/obj/effect/decal/cleanable/blood/gibs,
/turf/simulated/floor{
	icon_state = "white"
	},
/area/space)
"aA" = (
/obj/structure/grille,
/obj/structure/window/reinforced{
	dir = 5
	},
/turf/simulated/shuttle/plating,
/area/space)
"aB" = (
/obj/structure/table/glass,
/turf/simulated/floor{
	icon_state = "white"
	},
/area/space)
"aC" = (
/obj/item/ammo_casing/c9mm,
/obj/item/ammo_casing/c9mm,
/obj/item/ammo_casing/c9mm,
/obj/item/ammo_casing/c9mm,
/turf/simulated/floor{
	icon_state = "white"
	},
/area/space)
"aD" = (
/obj/machinery/smartfridge/secure/virology,
/turf/simulated/floor{
	icon_state = "white"
	},
/area/space)
"aE" = (
/obj/item/ammo_casing/c9mm,
/obj/item/ammo_casing/c9mm,
/turf/simulated/floor{
	icon_state = "white"
	},
/area/space)
"aF" = (
/obj/item/clothing/under/ert,
/obj/effect/decal/remains/human,
/turf/simulated/floor{
	icon_state = "white"
	},
/area/space)
"aG" = (
/obj/structure/stool/bed/chair/office/light{
	dir = 1
	},
/turf/simulated/floor{
	icon_state = "white"
	},
/area/space)
"aH" = (
/obj/item/ammo_casing/a74,
/turf/simulated/floor{
	icon_state = "white"
	},
/area/space)
"aI" = (
/obj/machinery/disease2/diseaseanalyser,
/turf/simulated/floor{
	icon_state = "white"
	},
/area/space)
"aK" = (
/obj/structure/table/glass,
/obj/item/weapon/storage/fancy/vials,
/turf/simulated/floor{
	icon_state = "white"
	},
/area/space)
"aL" = (
/obj/item/ammo_casing/a74,
/obj/item/ammo_casing/a74,
/obj/effect/decal/cleanable/blood/gibs,
/turf/simulated/floor{
	icon_state = "white"
	},
/area/space)
"aM" = (
/obj/item/weapon/shard,
/turf/simulated/floor{
	icon_state = "white"
	},
/area/space)
"aN" = (
/obj/effect/decal/remains/human,
/turf/simulated/floor{
	icon_state = "white"
	},
/area/space)
"aP" = (
/turf/simulated/shuttle/wall{
	icon_state = "swall_f6"
	},
/area/space)
"aQ" = (
/obj/item/ammo_box/magazine/m9mmr_2,
/turf/simulated/floor{
	icon_state = "white"
	},
/area/space)
"aR" = (
/turf/simulated/shuttle/wall{
	icon_state = "swall14"
	},
/area/space)
"aS" = (
/obj/effect/decal/cleanable/vomit,
/turf/simulated/floor{
	dir = 3;
	icon_state = "whitegreen"
	},
/area/space)
"aT" = (
/obj/item/weapon/paper_bin,
/turf/simulated/floor{
	icon_state = "white"
	},
/area/space)
"aU" = (
/turf/simulated/floor{
	dir = 3;
	icon_state = "whitegreen"
	},
/area/space)
"aW" = (
/obj/effect/decal/cleanable/blood/gibs,
/turf/simulated/floor{
	icon_state = "white"
	},
/area/space)
"aX" = (
/obj/machinery/door/airlock/virology/glass{
	name = "Isolation A";
	req_access = list(39)
	},
/turf/simulated/floor{
	icon_state = "white"
	},
/area/space)
"aZ" = (
/obj/item/ammo_casing/a74,
/obj/effect/decal/remains/human,
/turf/simulated/floor{
	dir = 3;
	icon_state = "whitegreen"
	},
/area/space)
"ba" = (
/turf/simulated/shuttle/wall{
	icon_state = "swall_f5"
	},
/area/space)
"bb" = (
/turf/simulated/floor{
	dir = 1;
	icon_state = "warnwhite"
	},
/area/space)
"bc" = (
/obj/structure/grille{
	density = 0;
	icon_state = "brokengrille"
	},
/obj/item/weapon/shard,
/turf/simulated/shuttle/plating,
/area/space)
"bd" = (
/obj/machinery/computer/centrifuge,
/turf/simulated/floor{
	icon_state = "white"
	},
/area/space)
"bg" = (
/obj/effect/decal/cleanable/blood/gibs/body,
/turf/simulated/floor{
	icon_state = "white"
	},
/area/space)
"bi" = (
/obj/structure/cable{
	d1 = 1;
	d2 = 2;
	icon_state = "1-2"
	},
/turf/simulated/floor{
	icon_state = "white"
	},
/area/space)
"bj" = (
/obj/effect/decal/cleanable/vomit,
/turf/simulated/floor{
	icon_state = "white"
	},
/area/space)
"bk" = (
/obj/item/weapon/bedsheet/medical,
/turf/simulated/floor{
	icon_state = "white"
	},
/area/space)
"bl" = (
/obj/effect/landmark/corpse/doctor,
/obj/effect/decal/cleanable/blood,
/obj/effect/decal/cleanable/blood/gibs,
/turf/simulated/floor{
	icon_state = "white"
	},
/area/space)
"bm" = (
/obj/machinery/computer/diseasesplicer,
/turf/simulated/floor{
	icon_state = "white"
	},
/area/space)
"bn" = (
/obj/machinery/disease2/incubator,
/turf/simulated/floor{
	icon_state = "white"
	},
/area/space)
"bo" = (
/obj/machinery/chem_master,
/turf/simulated/floor{
	icon_state = "white"
	},
/area/space)
"bp" = (
/obj/machinery/power/apc{
	dir = 8;
	environ = 0;
	equipment = 0;
	lighting = 0;
	locked = 0;
	name = "Worn-out APC";
	pixel_x = -24
	},
/obj/structure/cable{
	d2 = 2;
	icon_state = "0-2"
	},
/turf/simulated/floor{
	icon_state = "white"
	},
/area/space)
"bq" = (
/obj/effect/decal/cleanable/blood,
/turf/simulated/floor{
	icon_state = "warnwhite"
	},
/area/space)
"br" = (
/obj/item/ammo_casing/c9mm,
/turf/simulated/floor{
	icon_state = "white"
	},
/area/space)
"bs" = (
/obj/structure/stool/bed,
/obj/effect/decal/cleanable/vomit,
/turf/simulated/floor{
	icon_state = "white"
	},
/area/space)
"bt" = (
/obj/effect/decal/cleanable/blood/gibs/limb,
/turf/simulated/floor{
	icon_state = "white"
	},
/area/space)
"bu" = (
/obj/structure/grille{
	density = 0;
	icon_state = "brokengrille"
	},
/turf/simulated/floor{
	icon_state = "white"
	},
/area/space)
"bv" = (
/obj/structure/stool/bed,
/turf/simulated/floor{
	icon_state = "white"
	},
/area/space)
"bw" = (
/obj/effect/decal/cleanable/blood,
/turf/simulated/floor{
	dir = 8;
	icon_state = "whitegreen"
	},
/area/space)
"bx" = (
/turf/simulated/floor{
	dir = 4;
	icon_state = "whitegreen"
	},
/area/space)
"by" = (
/obj/machinery/door/airlock/virology/glass{
	name = "Virology";
	req_access = list(39)
	},
/turf/simulated/floor{
	icon_state = "white"
	},
/area/space)
"bz" = (
/obj/structure/cable{
	d1 = 1;
	d2 = 2;
	icon_state = "1-2"
	},
/turf/simulated/floor{
	icon_state = "damaged1"
	},
/area/space)
"bA" = (
/turf/simulated/floor{
	icon_state = "damaged1"
	},
/area/space)
"bB" = (
/obj/machinery/door/airlock/security/glass,
/obj/structure/cable{
	d1 = 1;
	d2 = 2;
	icon_state = "1-2"
	},
/turf/simulated/floor{
	icon_state = "white"
	},
/area/space)
"bC" = (
/obj/item/weapon/spike,
/turf/space,
/area/space)
"bD" = (
/obj/structure/closet/l3closet/general,
/turf/simulated/floor{
	icon_state = "white"
	},
/area/space)
"bE" = (
/obj/structure/sink{
	dir = 4;
	pixel_x = 12
	},
/obj/structure/dryer{
	pixel_y = 24
	},
/turf/simulated/floor{
	icon_state = "white"
	},
/area/space)
"bF" = (
/obj/machinery/light{
	dir = 8
	},
/turf/simulated/floor{
	icon_state = "white"
	},
/area/space)
"bG" = (
/turf/simulated/shuttle/wall{
	icon_state = "swall13"
	},
/area/space)
"bH" = (
/obj/structure/grille{
	density = 0;
	icon_state = "brokengrille"
	},
/obj/item/weapon/shard,
/turf/simulated/floor{
	icon_state = "white"
	},
/area/space)
"bI" = (
/obj/machinery/light{
	dir = 4
	},
/turf/simulated/floor{
	icon_state = "white"
	},
/area/space)
"bJ" = (
/obj/structure/cable{
	d1 = 4;
	d2 = 8;
	icon_state = "4-8"
	},
/turf/simulated/floor/plating/airless/catwalk,
/area/space)
"bK" = (
/obj/structure/closet/l3closet/security,
/turf/simulated/floor{
	icon_state = "white"
	},
/area/space)
"bL" = (
/obj/structure/rack,
/turf/simulated/floor{
	icon_state = "white"
	},
/area/space)
"bN" = (
/obj/machinery/shower{
	dir = 8
	},
/turf/simulated/floor{
	icon_state = "white"
	},
/area/space)
"bO" = (
/obj/structure/rack,
/obj/item/weapon/gun/energy/taser,
/turf/simulated/floor{
	icon_state = "white"
	},
/area/space)
"bP" = (
/obj/effect/decal/cleanable/blood,
/turf/simulated/floor{
	dir = 4;
	icon_state = "whitegreen"
	},
/area/space)
"bQ" = (
/obj/machinery/light{
	dir = 1
	},
/turf/simulated/floor{
	icon_state = "white"
	},
/area/space)
"bR" = (
/obj/structure/flora/plant/random,
/turf/simulated/floor{
	icon_state = "white"
	},
/area/space)
"bS" = (
/obj/structure/stool/bed,
/obj/item/weapon/bedsheet/medical,
/obj/effect/decal/cleanable/vomit,
/turf/simulated/floor{
	icon_state = "white"
	},
/area/space)
"bT" = (
/obj/structure/stool/bed,
/obj/item/weapon/bedsheet/medical,
/turf/simulated/floor{
	icon_state = "white"
	},
/area/space)
"bU" = (
/obj/item/stack/sheet/metal,
/turf/space,
/area/space)
"bV" = (
/turf/simulated/floor{
	dir = 8;
	icon_state = "whitegreen"
	},
/area/space)
"bW" = (
/turf/simulated/shuttle/wall{
	icon_state = "swall_s5"
	},
/area/space)
"bX" = (
/obj/machinery/light_construct/small,
/turf/simulated/floor{
	icon_state = "white"
	},
/area/space)
"bY" = (
/obj/machinery/light/small,
/turf/simulated/floor{
	icon_state = "white"
	},
/area/space)
"bZ" = (
/obj/structure/grille,
/obj/structure/window/reinforced{
	dir = 5
	},
/turf/simulated/floor{
	icon_state = "white"
	},
/area/space)
"ca" = (
/turf/simulated/floor{
	icon_state = "damaged4"
	},
/area/space)
"cb" = (
/obj/structure/table/glass,
/obj/item/weapon/reagent_containers/glass/beaker,
/obj/structure/reagent_dispensers/virusfood{
	pixel_y = 30
	},
/turf/simulated/floor{
	icon_state = "white"
	},
/area/space)
"cc" = (
/obj/item/weapon/shard,
/turf/space,
/area/space)
"cd" = (
/turf/simulated/shuttle/wall{
	icon_state = "swall_s9"
	},
/area/space)
"ce" = (
/obj/machinery/light{
	dir = 1
	},
/obj/structure/filingcabinet/medical,
/turf/simulated/floor{
	icon_state = "white"
	},
/area/space)
"cf" = (
/obj/structure/stool/bed/chair/office/light,
/turf/simulated/floor{
	icon_state = "white"
	},
/area/space)
"cg" = (
/obj/structure/cable{
	d1 = 1;
	d2 = 2;
	icon_state = "1-2"
	},
/turf/simulated/floor{
	icon_state = "damaged4"
	},
/area/space)
"ch" = (
/obj/machinery/door/airlock/engineering/glass,
/turf/simulated/floor{
	icon_state = "damaged1"
	},
/area/space)
"ci" = (
/turf/simulated/floor{
	icon_state = "warnwhite"
	},
/area/space)
"cj" = (
/obj/machinery/power/solar{
	id = "portsolar";
	name = "Port Solar Array"
	},
/turf/simulated/floor/airless{
	icon_state = "solarpanel"
	},
/area/space)
"ck" = (
/obj/item/weapon/spike,
/obj/structure/cable{
	d1 = 2;
	d2 = 8;
	icon_state = "2-8"
	},
/turf/simulated/floor/plating/airless/catwalk,
/area/space)
"cl" = (
/turf/simulated/floor/plating/airless/catwalk,
/area/space)
"cm" = (
/obj/machinery/suit_storage_unit/science,
/turf/simulated/floor{
	icon_state = "warndark"
	},
/area/space)
"cn" = (
/obj/machinery/suit_storage_unit/science,
/obj/machinery/light_construct/small{
	dir = 1
	},
/turf/simulated/floor{
	icon_state = "warndark"
	},
/area/space)
"co" = (
/obj/machinery/portable_atmospherics/canister/air,
/turf/simulated/floor{
	icon_state = "warndark"
	},
/area/space)
"cp" = (
/obj/structure/rack,
/obj/item/clothing/suit/space/rig/engineering,
/obj/item/clothing/mask/breath,
/obj/item/clothing/head/helmet/space/rig/engineering,
/obj/machinery/light_construct/small{
	dir = 1
	},
/turf/simulated/floor,
/area/space)
"cq" = (
/obj/structure/rack,
/obj/item/clothing/head/helmet/space/rig/engineering,
/turf/simulated/floor,
/area/space)
"cr" = (
/obj/item/weapon/spike,
/turf/simulated/floor/plating/airless/catwalk,
/area/space)
"cs" = (
/obj/machinery/computer/rdconsole/core,
/turf/simulated/floor{
	icon_state = "white"
	},
/area/space)
"ct" = (
/obj/structure/table/glass,
/obj/item/weapon/paper_bin,
/turf/simulated/floor{
	icon_state = "white"
	},
/area/space)
"cu" = (
/obj/effect/landmark/corpse/scientist,
/turf/simulated/floor{
	icon_state = "white"
	},
/area/space)
"cv" = (
/obj/machinery/door/airlock/research/glass{
	name = "Research and Development";
	req_access = list(7)
	},
/turf/simulated/floor{
	icon_state = "white"
	},
/area/space)
"cw" = (
/turf/simulated/floor/airless{
	icon_state = "solarpanel"
	},
/area/space)
"cx" = (
/obj/structure/lattice,
/turf/space,
/area/space)
"cy" = (
/turf/simulated/floor{
	icon_state = "dark"
	},
/area/space)
"cz" = (
/obj/effect/decal/remains/human,
/turf/simulated/floor{
	icon_state = "dark"
	},
/area/space)
"cA" = (
/obj/item/stack/cable_coil/red,
/turf/space,
/area/space)
"cB" = (
/turf/simulated/floor{
	icon_state = "warndark"
	},
/area/space)
"cC" = (
/obj/item/stack/sheet/metal,
/turf/simulated/floor/plating/airless/catwalk,
/area/space)
"cD" = (
/obj/item/stack/cable_coil/red{
	pixel_x = 3;
	pixel_y = -7
	},
/turf/simulated/floor/plating/airless/catwalk,
/area/space)
"cE" = (
/obj/structure/table/glass,
/obj/item/device/antibody_scanner,
/obj/item/device/healthanalyzer{
	pixel_y = 2
	},
/turf/simulated/floor{
	icon_state = "white"
	},
/area/space)
"cG" = (
/obj/structure/cable{
	d1 = 1;
	d2 = 8;
	icon_state = "1-8"
	},
/turf/simulated/floor/plating/airless/catwalk,
/area/space)
"cH" = (
/obj/item/stack/cable_coil/red{
	pixel_x = -3;
	pixel_y = 3
	},
/turf/simulated/floor/plating/airless/catwalk,
/area/space)
"cI" = (
/obj/item/weapon/paper{
	info = "MSBL-113 entrusted: 1) Investigate an unknown virus strain from the planet Omicron 8. 2) Make a copy of the virus, and modify it with: a) Phoron b) Radiation c) Toxin LL-7. Received results must be documented. Responsible for maintaining records - Leonid Skvortsov. Sincerely, member of the expedition EKB-410 - L.Trovato.";
	name = "Task"
	},
/turf/simulated/floor{
	icon_state = "white"
	},
/area/space)
"lt" = (
/obj/structure/flora/plant/floorleaf,
/turf/simulated/floor{
	icon_state = "white"
	},
/area/space)
"mG" = (
/obj/machinery/r_n_d/protolathe,
/turf/simulated/floor{
	icon_state = "white"
	},
/area/space)
"oK" = (
/obj/structure/filingcabinet/chestdrawer,
/turf/simulated/floor{
	icon_state = "white"
	},
/area/space)
"qp" = (
/obj/machinery/autolathe,
/turf/simulated/floor{
	icon_state = "white"
	},
/area/space)
"wY" = (
/turf/simulated/shuttle/wall{
	icon_state = "swall7"
	},
/area/space)
"Fc" = (
/obj/machinery/r_n_d/destructive_analyzer,
/turf/simulated/floor{
	icon_state = "white"
	},
/area/space)
"IX" = (
/obj/machinery/door/airlock/external,
/turf/simulated/floor{
	icon_state = "dark"
	},
/area/space)
"LK" = (
/turf/simulated/shuttle/wall{
	icon_state = "swall11"
	},
/area/space)
"My" = (
/obj/item/weapon/circuitboard/smes,
/turf/space,
/area/space)
"Np" = (
/obj/item/clothing/shoes/magboots,
/turf/simulated/floor{
	icon_state = "dark"
	},
/area/space)
"Zu" = (
/obj/effect/decal/remains/human,
/turf/simulated/floor{
	icon_state = "damaged1"
	},
/area/space)

(1,1,1) = {"
aa
aa
aa
aP
ae
ae
ba
aa
aa
aP
ae
ae
ae
bW
aa
aa
aa
aa
aa
aa
aa
aa
"}
(2,1,1) = {"
aP
ae
ae
as
ay
ay
as
ae
ae
bG
bD
bD
ar
aR
ae
ae
ae
ae
ae
ae
ae
bW
"}
(3,1,1) = {"
ac
bo
ak
aB
az
ar
bb
bj
bq
by
ar
aW
ar
by
bb
ar
ci
ar
cs
bF
mG
ac
"}
(4,1,1) = {"
ac
ag
aG
ar
aC
ar
as
ae
ae
bG
bE
bN
ar
aR
ae
ae
as
an
aB
aG
Fc
ac
"}
(5,1,1) = {"
ac
aB
al
aB
aE
at
ac
aa
aa
af
ae
ae
ae
cd
aa
aa
ac
ar
ct
cI
qp
ac
"}
(6,1,1) = {"
ac
aD
ar
cE
aE
aW
ac
aa
aa
aa
aa
aa
aa
aa
aa
aa
ac
ar
aB
aG
oK
ac
"}
(7,1,1) = {"
ac
bm
cf
aK
br
aS
aR
ae
ae
ae
ae
ae
ae
ae
ba
aa
ac
bQ
cu
aW
ar
ac
"}
(8,1,1) = {"
ac
bd
ar
au
ar
aU
aX
ar
bx
at
bF
ar
bP
ar
ac
aa
ac
bR
ar
ar
lt
ac
"}
(9,1,1) = {"
ac
aI
am
av
aL
aZ
aR
ae
aX
ae
ae
ae
aX
ae
bG
aa
aR
ae
cv
wY
ae
cd
"}
(10,1,1) = {"
ac
bn
ar
aw
ar
aH
ac
bk
at
aM
bZ
ar
at
ar
ac
aa
ac
cm
cy
ac
aa
aa
"}
(11,1,1) = {"
ac
cb
ar
ar
at
ar
bc
bl
bs
ar
bH
ar
bS
bX
ac
aa
ac
cn
cz
ac
aa
aa
"}
(12,1,1) = {"
ac
ai
aG
ar
aF
ar
bc
at
ar
aB
bZ
aB
ar
ar
ac
aa
ac
cB
cy
aR
ae
ae
"}
(13,1,1) = {"
ac
ce
ar
aL
aH
aM
aA
bZ
bu
bZ
bZ
bZ
bZ
bZ
ac
aa
ac
co
cy
cy
Np
IX
"}
(14,1,1) = {"
ac
aB
aG
ar
ar
ar
aA
at
ar
aB
bZ
aB
ar
bj
ac
aa
ac
cB
cy
aR
ae
ae
"}
(15,1,1) = {"
ac
aj
an
aN
ar
bt
aA
ar
bv
ar
bZ
ar
bT
bY
ac
aa
ac
cp
cy
ac
aa
aa
"}
(16,1,1) = {"
ac
bn
ar
aB
at
ar
ac
bk
ar
ar
bZ
aN
ar
ar
ac
aa
ac
cq
cy
ac
aa
aa
"}
(17,1,1) = {"
ac
aI
at
aM
ar
aU
aR
ae
ah
ae
ae
ae
ah
ae
bG
aa
aR
ae
ch
LK
ae
bW
"}
(18,1,1) = {"
ac
bd
ao
aB
ar
aU
ah
ar
bw
ar
bI
ar
bV
ar
ac
aa
ac
bA
bA
bA
Zu
ac
"}
(19,1,1) = {"
ac
bm
cf
aK
aT
aU
aR
ae
ae
ae
ae
ae
ae
ae
cd
aa
ac
bA
aa
ca
ca
ac
"}
(20,1,1) = {"
ac
aD
ar
ar
aQ
at
ac
aa
aa
aa
aa
aa
aa
aa
aa
aa
ac
ca
bC
bU
aa
aa
"}
(21,1,1) = {"
ac
aB
ap
aB
ar
ar
ac
aa
aa
aP
ae
ae
ae
bW
aa
aa
ac
ca
cA
My
bC
bU
"}
(22,1,1) = {"
ac
ag
aG
ar
ar
ar
as
ae
ae
bG
bK
bK
ar
aR
ae
ae
as
bU
bC
bC
aa
aa
"}
(23,1,1) = {"
ac
bo
aq
aB
ar
ar
bg
bp
bi
bB
bi
bi
bi
ca
bA
cg
bz
bA
bC
bC
bC
aa
"}
(24,1,1) = {"
af
ae
ae
as
ay
ay
as
ae
ae
bG
bL
bO
ar
aR
ae
ae
ae
ae
cC
aa
bU
bC
"}
(25,1,1) = {"
aa
aa
aa
ax
ae
ae
ab
aa
aa
af
ae
ae
ae
cd
aa
aa
aa
bC
bJ
aa
aa
aa
"}
(26,1,1) = {"
aa
aa
aa
aa
aa
aa
aa
aa
aa
aa
aa
aa
aa
aa
aa
aa
cj
aa
cD
bC
cc
aa
"}
(27,1,1) = {"
aa
aa
aa
aa
aa
aa
aa
aa
aa
aa
aa
aa
aa
aa
aa
aa
ck
cr
cG
cl
cl
aa
"}
(28,1,1) = {"
aa
aa
aa
aa
aa
aa
aa
aa
aa
aa
aa
aa
aa
aa
aa
bC
cw
aa
cH
aa
aa
cc
"}
(29,1,1) = {"
aa
aa
aa
aa
aa
aa
aa
aa
aa
aa
aa
aa
aa
aa
cc
cw
aa
cc
cl
aa
aa
cc
"}
(30,1,1) = {"
aa
aa
aa
aa
aa
aa
aa
aa
aa
aa
aa
aa
aa
aa
cc
cx
cx
cl
cl
aa
aa
aa
"}
