"aa" = (/turf/space,/area/space)
"ab" = (/turf/simulated/shuttle/wall{icon_state = "swall_f9"},/area/space)
"ac" = (/turf/simulated/shuttle/wall{icon_state = "swall12"},/area/space)
"ae" = (/turf/simulated/shuttle/wall{icon_state = "swall3"},/area/space)
"af" = (/turf/simulated/shuttle/wall{icon_state = "swall_f10"},/area/space)
"ag" = (/obj/machinery/chem_dispenser,/turf/simulated/floor{icon_state = "white"},/area/space)
"ah" = (/obj/machinery/door/airlock/virology/glass{name = "Isolation B"; req_access = list(39)},/turf/simulated/floor{icon_state = "white"},/area/space)
"ai" = (/obj/structure/table/glass,/obj/item/weapon/paper{info = "Information about the virus from the planet Omicron-8. The virus behaves unpredictably. Five weeks ago, when you delivered it to us, it was calm, and caused only cough and a little nausea. A week later, the virus caused bloody vomiting and severe epilepsy. Two weeks after delivery, it caused strong aggression, and was transmitted not through airborne droplets, but through blood and saliva."; name = "Report #1"},/turf/simulated/floor{icon_state = "white"},/area/space)
"aj" = (/obj/structure/table/glass,/obj/structure/reagent_dispensers/virusfood{pixel_y = 30},/turf/simulated/floor{icon_state = "white"},/area/space)
"ak" = (/obj/structure/table/glass,/obj/machinery/light{dir = 8},/turf/simulated/floor{icon_state = "white"},/area/space)
"al" = (/obj/structure/table/glass,/obj/item/weapon/reagent_containers/glass/beaker/large,/turf/simulated/floor{icon_state = "white"},/area/space)
"am" = (/obj/effect/decal/cleanable/blood,/obj/effect/landmark/corpse/doctor,/turf/simulated/floor{icon_state = "white"},/area/space)
"an" = (/obj/item/weapon/pen,/turf/simulated/floor{icon_state = "white"},/area/space)
"ao" = (/obj/item/weapon/paper{info = "The preliminary name of the virus is PAX-12. 6 weeks after delivery, the infected began to attack the medical staff and security officers. Some infected are trying to get out of isolation cells."; name = "Report #2"},/turf/simulated/floor{icon_state = "white"},/area/space)
"ap" = (/obj/structure/table/glass,/obj/item/weapon/reagent_containers/glass/beaker/bluespace,/turf/simulated/floor{icon_state = "white"},/area/space)
"aq" = (/obj/structure/table/glass,/obj/machinery/light{dir = 4},/turf/simulated/floor{icon_state = "white"},/area/space)
"ar" = (/turf/simulated/floor{icon_state = "white"},/area/space)
"as" = (/turf/simulated/shuttle/wall,/area/space)
"at" = (/obj/effect/decal/cleanable/blood,/turf/simulated/floor{icon_state = "white"},/area/space)
"au" = (/obj/structure/table/glass,/obj/item/weapon/reagent_containers/spray/cleaner,/turf/simulated/floor{icon_state = "white"},/area/space)
"av" = (/obj/structure/table/glass,/obj/item/weapon/paper_bin,/obj/item/weapon/pen,/turf/simulated/floor{icon_state = "white"},/area/space)
"aw" = (/obj/structure/table/glass,/obj/item/weapon/disk/research_points,/turf/simulated/floor{icon_state = "white"},/area/space)
"ax" = (/turf/simulated/shuttle/wall{icon_state = "swall_s10"},/area/space)
"ay" = (/obj/structure/closet/emcloset,/turf/simulated/floor{icon_state = "white"},/area/space)
"az" = (/obj/item/clothing/shoes/combat,/obj/effect/decal/cleanable/blood,/obj/item/ammo_casing/c9mm,/obj/item/ammo_casing/c9mm,/obj/item/clothing/under/ert,/obj/effect/decal/remains/human,/obj/effect/decal/cleanable/blood/gibs,/turf/simulated/floor{icon_state = "white"},/area/space)
"aA" = (/obj/structure/grille,/obj/structure/window/reinforced{dir = 5},/turf/simulated/shuttle/plating,/area/space)
"aB" = (/obj/structure/table/glass,/turf/simulated/floor{icon_state = "white"},/area/space)
"aC" = (/obj/item/ammo_casing/c9mm,/obj/item/ammo_casing/c9mm,/obj/item/ammo_casing/c9mm,/obj/item/ammo_casing/c9mm,/turf/simulated/floor{icon_state = "white"},/area/space)
"aD" = (/obj/machinery/smartfridge/secure/virology,/turf/simulated/floor{icon_state = "white"},/area/space)
"aE" = (/obj/item/ammo_casing/c9mm,/obj/item/ammo_casing/c9mm,/turf/simulated/floor{icon_state = "white"},/area/space)
"aF" = (/obj/item/clothing/under/ert,/obj/effect/decal/remains/human,/turf/simulated/floor{icon_state = "white"},/area/space)
"aG" = (/obj/structure/stool/bed/chair/office/light{dir = 1},/turf/simulated/floor{icon_state = "white"},/area/space)
"aH" = (/obj/item/ammo_casing/a74,/turf/simulated/floor{icon_state = "white"},/area/space)
"aI" = (/obj/machinery/disease2/diseaseanalyser,/turf/simulated/floor{icon_state = "white"},/area/space)
"aK" = (/obj/structure/table/glass,/obj/item/weapon/storage/fancy/vials,/turf/simulated/floor{icon_state = "white"},/area/space)
"aL" = (/obj/item/ammo_casing/a74,/obj/item/ammo_casing/a74,/obj/effect/decal/cleanable/blood/gibs,/turf/simulated/floor{icon_state = "white"},/area/space)
"aM" = (/obj/item/weapon/shard,/turf/simulated/floor{icon_state = "white"},/area/space)
"aN" = (/obj/effect/decal/remains/human,/turf/simulated/floor{icon_state = "white"},/area/space)
"aP" = (/turf/simulated/shuttle/wall{icon_state = "swall_f6"},/area/space)
"aQ" = (/obj/item/ammo_box/magazine/m9mmr_2,/turf/simulated/floor{icon_state = "white"},/area/space)
"aR" = (/turf/simulated/shuttle/wall{icon_state = "swall14"},/area/space)
"aS" = (/obj/effect/decal/cleanable/vomit,/turf/simulated/floor{dir = 3; icon_state = "whitegreen"},/area/space)
"aT" = (/obj/item/weapon/paper_bin,/turf/simulated/floor{icon_state = "white"},/area/space)
"aU" = (/turf/simulated/floor{dir = 3; icon_state = "whitegreen"},/area/space)
"aW" = (/obj/effect/decal/cleanable/blood/gibs,/turf/simulated/floor{icon_state = "white"},/area/space)
"aX" = (/obj/machinery/door/airlock/virology/glass{name = "Isolation A"; req_access = list(39)},/turf/simulated/floor{icon_state = "white"},/area/space)
"aZ" = (/obj/item/ammo_casing/a74,/obj/effect/decal/remains/human,/turf/simulated/floor{dir = 3; icon_state = "whitegreen"},/area/space)
"ba" = (/turf/simulated/shuttle/wall{icon_state = "swall_f5"},/area/space)
"bb" = (/turf/simulated/floor{dir = 1; icon_state = "warnwhite"},/area/space)
"bc" = (/obj/structure/grille{density = 0; icon_state = "brokengrille"},/obj/item/weapon/shard,/turf/simulated/shuttle/plating,/area/space)
"bd" = (/obj/machinery/computer/centrifuge,/turf/simulated/floor{icon_state = "white"},/area/space)
"bg" = (/obj/effect/decal/cleanable/blood/gibs/body,/turf/simulated/floor{icon_state = "white"},/area/space)
"bi" = (/obj/structure/cable{d1 = 1; d2 = 2; icon_state = "1-2"},/turf/simulated/floor{icon_state = "white"},/area/space)
"bj" = (/obj/effect/decal/cleanable/vomit,/turf/simulated/floor{icon_state = "white"},/area/space)
"bk" = (/obj/item/weapon/bedsheet/medical,/turf/simulated/floor{icon_state = "white"},/area/space)
"bl" = (/obj/effect/landmark/corpse/doctor,/obj/effect/decal/cleanable/blood,/obj/effect/decal/cleanable/blood/gibs,/turf/simulated/floor{icon_state = "white"},/area/space)
"bm" = (/obj/machinery/computer/diseasesplicer,/turf/simulated/floor{icon_state = "white"},/area/space)
"bn" = (/obj/machinery/disease2/incubator,/turf/simulated/floor{icon_state = "white"},/area/space)
"bo" = (/obj/machinery/chem_master,/turf/simulated/floor{icon_state = "white"},/area/space)
"bp" = (/obj/machinery/power/apc{dir = 8; environ = 0; equipment = 0; lighting = 0; locked = 0; name = "Worn-out APC"; pixel_x = -24},/obj/structure/cable{d2 = 2; icon_state = "0-2"},/turf/simulated/floor{icon_state = "white"},/area/space)
"bq" = (/obj/effect/decal/cleanable/blood,/turf/simulated/floor{icon_state = "warnwhite"},/area/space)
"br" = (/obj/item/ammo_casing/c9mm,/turf/simulated/floor{icon_state = "white"},/area/space)
"bs" = (/obj/structure/stool/bed,/obj/effect/decal/cleanable/vomit,/turf/simulated/floor{icon_state = "white"},/area/space)
"bt" = (/obj/effect/decal/cleanable/blood/gibs/limb,/turf/simulated/floor{icon_state = "white"},/area/space)
"bu" = (/obj/structure/grille{density = 0; icon_state = "brokengrille"},/turf/simulated/floor{icon_state = "white"},/area/space)
"bv" = (/obj/structure/stool/bed,/turf/simulated/floor{icon_state = "white"},/area/space)
"bw" = (/obj/effect/decal/cleanable/blood,/turf/simulated/floor{dir = 8; icon_state = "whitegreen"},/area/space)
"bx" = (/turf/simulated/floor{dir = 4; icon_state = "whitegreen"},/area/space)
"by" = (/obj/machinery/door/airlock/virology/glass{name = "Virology"; req_access = list(39)},/turf/simulated/floor{icon_state = "white"},/area/space)
"bz" = (/obj/structure/cable{d1 = 1; d2 = 2; icon_state = "1-2"},/turf/simulated/floor{icon_state = "damaged1"},/area/space)
"bA" = (/turf/simulated/floor{icon_state = "damaged1"},/area/space)
"bB" = (/obj/machinery/door/airlock/security/glass,/obj/structure/cable{d1 = 1; d2 = 2; icon_state = "1-2"},/turf/simulated/floor{icon_state = "white"},/area/space)
"bC" = (/obj/item/weapon/spike,/turf/space,/area/space)
"bD" = (/obj/structure/closet/l3closet/general,/turf/simulated/floor{icon_state = "white"},/area/space)
"bE" = (/obj/structure/sink{dir = 4; pixel_x = 12},/obj/structure/dryer{pixel_y = 24},/turf/simulated/floor{icon_state = "white"},/area/space)
"bF" = (/obj/machinery/light{dir = 8},/turf/simulated/floor{icon_state = "white"},/area/space)
"bG" = (/turf/simulated/shuttle/wall{icon_state = "swall13"},/area/space)
"bH" = (/obj/structure/grille{density = 0; icon_state = "brokengrille"},/obj/item/weapon/shard,/turf/simulated/floor{icon_state = "white"},/area/space)
"bI" = (/obj/machinery/light{dir = 4},/turf/simulated/floor{icon_state = "white"},/area/space)
"bJ" = (/obj/structure/cable{d1 = 4; d2 = 8; icon_state = "4-8"},/turf/simulated/floor/plating/airless/catwalk,/area/space)
"bK" = (/obj/structure/closet/l3closet/security,/turf/simulated/floor{icon_state = "white"},/area/space)
"bL" = (/obj/structure/rack,/turf/simulated/floor{icon_state = "white"},/area/space)
"bN" = (/obj/machinery/shower{dir = 8},/turf/simulated/floor{icon_state = "white"},/area/space)
"bO" = (/obj/structure/rack,/obj/item/weapon/gun/energy/taser,/turf/simulated/floor{icon_state = "white"},/area/space)
"bP" = (/obj/effect/decal/cleanable/blood,/turf/simulated/floor{dir = 4; icon_state = "whitegreen"},/area/space)
"bQ" = (/obj/machinery/light{dir = 1},/turf/simulated/floor{icon_state = "white"},/area/space)
"bR" = (/obj/structure/flora/plant/random,/turf/simulated/floor{icon_state = "white"},/area/space)
"bS" = (/obj/structure/stool/bed,/obj/item/weapon/bedsheet/medical,/obj/effect/decal/cleanable/vomit,/turf/simulated/floor{icon_state = "white"},/area/space)
"bT" = (/obj/structure/stool/bed,/obj/item/weapon/bedsheet/medical,/turf/simulated/floor{icon_state = "white"},/area/space)
"bU" = (/obj/item/stack/sheet/metal,/turf/space,/area/space)
"bV" = (/turf/simulated/floor{dir = 8; icon_state = "whitegreen"},/area/space)
"bW" = (/turf/simulated/shuttle/wall{icon_state = "swall_s5"},/area/space)
"bX" = (/obj/machinery/light_construct/small,/turf/simulated/floor{icon_state = "white"},/area/space)
"bY" = (/obj/machinery/light/small,/turf/simulated/floor{icon_state = "white"},/area/space)
"bZ" = (/obj/structure/grille,/obj/structure/window/reinforced{dir = 5},/turf/simulated/floor{icon_state = "white"},/area/space)
"ca" = (/turf/simulated/floor{icon_state = "damaged4"},/area/space)
"cb" = (/obj/structure/table/glass,/obj/item/weapon/reagent_containers/glass/beaker,/obj/structure/reagent_dispensers/virusfood{pixel_y = 30},/turf/simulated/floor{icon_state = "white"},/area/space)
"cc" = (/obj/item/weapon/shard,/turf/space,/area/space)
"cd" = (/turf/simulated/shuttle/wall{icon_state = "swall_s9"},/area/space)
"ce" = (/obj/machinery/light{dir = 1},/obj/structure/filingcabinet/medical,/turf/simulated/floor{icon_state = "white"},/area/space)
"cf" = (/obj/structure/stool/bed/chair/office/light,/turf/simulated/floor{icon_state = "white"},/area/space)
"cg" = (/obj/structure/cable{d1 = 1; d2 = 2; icon_state = "1-2"},/turf/simulated/floor{icon_state = "damaged4"},/area/space)
"ch" = (/obj/machinery/door/airlock/engineering/glass,/turf/simulated/floor{icon_state = "damaged1"},/area/space)
"ci" = (/turf/simulated/floor{icon_state = "warnwhite"},/area/space)
"cj" = (/obj/machinery/power/solar{id = "portsolar"; name = "Port Solar Array"},/turf/simulated/floor/airless{icon_state = "solarpanel"},/area/space)
"ck" = (/obj/item/weapon/spike,/obj/structure/cable{d1 = 2; d2 = 8; icon_state = "2-8"},/turf/simulated/floor/plating/airless/catwalk,/area/space)
"cl" = (/turf/simulated/floor/plating/airless/catwalk,/area/space)
"cm" = (/obj/machinery/suit_storage_unit/science,/turf/simulated/floor{icon_state = "warndark"},/area/space)
"cn" = (/obj/machinery/suit_storage_unit/science,/obj/machinery/light_construct/small{dir = 1},/turf/simulated/floor{icon_state = "warndark"},/area/space)
"co" = (/obj/machinery/portable_atmospherics/canister/air,/turf/simulated/floor{icon_state = "warndark"},/area/space)
"cp" = (/obj/structure/rack,/obj/item/clothing/suit/space/rig/engineering,/obj/item/clothing/mask/breath,/obj/item/clothing/head/helmet/space/rig/engineering,/obj/machinery/light_construct/small{dir = 1},/turf/simulated/floor,/area/space)
"cq" = (/obj/structure/rack,/obj/item/clothing/head/helmet/space/rig/engineering,/turf/simulated/floor,/area/space)
"cr" = (/obj/item/weapon/spike,/turf/simulated/floor/plating/airless/catwalk,/area/space)
"cs" = (/obj/machinery/computer/rdconsole/core,/turf/simulated/floor{icon_state = "white"},/area/space)
"ct" = (/obj/structure/table/glass,/obj/item/weapon/paper_bin,/turf/simulated/floor{icon_state = "white"},/area/space)
"cu" = (/obj/effect/landmark/corpse/scientist,/turf/simulated/floor{icon_state = "white"},/area/space)
"cv" = (/obj/machinery/door/airlock/research/glass{name = "Research and Development"; req_access = list(7)},/turf/simulated/floor{icon_state = "white"},/area/space)
"cw" = (/turf/simulated/floor/airless{icon_state = "solarpanel"},/area/space)
"cx" = (/obj/structure/lattice,/turf/space,/area/space)
"cy" = (/turf/simulated/floor{icon_state = "dark"},/area/space)
"cz" = (/obj/effect/decal/remains/human,/turf/simulated/floor{icon_state = "dark"},/area/space)
"cA" = (/obj/item/stack/cable_coil/red,/turf/space,/area/space)
"cB" = (/turf/simulated/floor{icon_state = "warndark"},/area/space)
"cC" = (/obj/item/stack/sheet/metal,/turf/simulated/floor/plating/airless/catwalk,/area/space)
"cD" = (/obj/item/stack/cable_coil/red{pixel_x = 3; pixel_y = -7},/turf/simulated/floor/plating/airless/catwalk,/area/space)
"cE" = (/obj/structure/table/glass,/obj/item/device/antibody_scanner,/obj/item/device/healthanalyzer{pixel_y = 2},/turf/simulated/floor{icon_state = "white"},/area/space)
"cG" = (/obj/structure/cable{d1 = 1; d2 = 8; icon_state = "1-8"},/turf/simulated/floor/plating/airless/catwalk,/area/space)
"cH" = (/obj/item/stack/cable_coil/red{pixel_x = -3; pixel_y = 3},/turf/simulated/floor/plating/airless/catwalk,/area/space)
"cI" = (/obj/item/weapon/paper{info = "MSBL-113 entrusted: 1) Investigate an unknown virus strain from the planet Omicron 8. 2) Make a copy of the virus, and modify it with: a) Phoron b) Radiation c) Toxin LL-7. Received results must be documented. Responsible for maintaining records - Leonid Skvortsov. Sincerely, member of the expedition EKB-410 - L.Trovato."; name = "Task"},/turf/simulated/floor{icon_state = "white"},/area/space)
"lt" = (/obj/structure/flora/plant/floorleaf,/turf/simulated/floor{icon_state = "white"},/area/space)
"mG" = (/obj/machinery/r_n_d/protolathe,/turf/simulated/floor{icon_state = "white"},/area/space)
"oK" = (/obj/structure/filingcabinet/chestdrawer,/turf/simulated/floor{icon_state = "white"},/area/space)
"qp" = (/obj/machinery/autolathe,/turf/simulated/floor{icon_state = "white"},/area/space)
"wY" = (/turf/simulated/shuttle/wall{icon_state = "swall7"},/area/space)
"Fc" = (/obj/machinery/r_n_d/destructive_analyzer,/turf/simulated/floor{icon_state = "white"},/area/space)
"IX" = (/obj/machinery/door/airlock/external,/turf/simulated/floor{icon_state = "dark"},/area/space)
"LK" = (/turf/simulated/shuttle/wall{icon_state = "swall11"},/area/space)
"My" = (/obj/item/weapon/circuitboard/smes,/turf/space,/area/space)
"Np" = (/obj/item/clothing/shoes/magboots,/turf/simulated/floor{icon_state = "dark"},/area/space)
"Zu" = (/obj/effect/decal/remains/human,/turf/simulated/floor{icon_state = "damaged1"},/area/space)

(1,1,1) = {"
aaaPacacacacacacacacacacacacacacacacacacacacacafaaaaaaaaaaaa
aaaeboagaBaDbmbdaIbncbaiceaBajbnaIbdbmaDaBagboaeaaaaaaaaaaaa
aaaeakaGalarcfaramararaGaraGanarataocfarapaGaqaeaaaaaaaaaaaa
aPasaBaraBcEaKauavawararaLaraNaBaMaBaKaraBaraBasaxaaaaaaaaaa
aeayazaCaEaEbraraLarataFaHararatararaTaQarararayaeaaaaaaaaaa
aeayararataWaSaUaZaHararaMarbtaraUaUaUatarararayaeaaaaaaaaaa
baasbbasacacaRaXaRacbcbcaAaAaAacaRahaRacacasbgasabaaaaaaaaaa
aaaebjaeaaaaaearaebkblatbZatarbkaearaeaaaaaebpaeaaaaaaaaaaaa
aaaebqaeaaaaaebxaXatbsarbuarbvarahbwaeaaaaaebiaeaaaaaaaaaaaa
aPbGbybGafaaaeataeaMaraBbZaBararaearaeaaaPbGbBbGafaaaaaaaaaa
aebDarbEaeaaaebFaebZbHbZbZbZbZbZaebIaeaaaebKbibLaeaaaaaaaaaa
aebDaWbNaeaaaearaeararaBbZaBaraNaearaeaaaebKbibOaeaaaaaaaaaa
aearararaeaaaebPaXatbSarbZarbTarahbVaeaaaearbiaraeaaaaaaaaaa
bWaRbyaRcdaaaearaearbXarbZbjbYaraearaeaabWaRcaaRcdaaaaaaaaaa
aaaebbaeaaaabaacbGacacacacacacacbGaccdaaaaaebAaeaaaaaaaacccc
aaaearaeaaaaaaaaaaaaaaaaaaaaaaaaaaaaaaaaaaaecgaeaaaaaabCcwcx
aaaeciasacacacacaRacacacacacacacaRacacacacasbzaeaacjckcwaacx
aaaearanararbQbRaecmcncBcocBcpcqaebAbAcacabUbAaebCaacraacccl
aaaecsaBctaBcuarcvcyczcycycycycychbAaabCcAbCbCcCbJcDcGcHclcl
aaaebFaGcIaGaWarwYacacaRcyaRacacLKbAcabUMybCbCaaaabCclaaaaaa
aaaemGFcqpoKarltaeaaaaaeNpaeaaaaaeZucaaabCaabCbUaaccclaaaaaa
aabWacacacacacaccdaaaaaeIXaeaaaabWacacaabUaaaabCaaaaaaccccaa
"}
