//MAP CONVERTED BY dmm2tgm.py THIS HEADER COMMENT PREVENTS RECONVERSION, DO NOT REMOVE
"aa" = (
/turf/space,
/area/space)
"ab" = (
/obj/structure/shuttle/engine/propulsion{
	dir = 1
	},
/turf/space,
/area/agrospheregarden)
"ac" = (
/obj/structure/shuttle/engine/heater{
	dir = 1
	},
/obj/structure/window/reinforced{
	dir = 4
	},
/obj/structure/window/reinforced{
	dir = 8;
	req_access = list(72)
	},
/obj/structure/window/reinforced,
/turf/simulated/floor/plating,
/area/agrospheregarden)
"ad" = (
/turf/simulated/wall,
/area/agrospheregarden)
"ae" = (
/obj/machinery/chem_dispenser,
/turf/simulated/floor{
	icon_state = "white"
	},
/area/agrospheregarden)
"af" = (
/obj/structure/table/glass,
/obj/item/weapon/storage/pill_bottle/zoom{
	pixel_x = -4
	},
/obj/item/weapon/storage/pill_bottle/paroxetine{
	pixel_x = 3;
	pixel_y = 8
	},
/obj/item/weapon/storage/pill_bottle/citalopram{
	pixel_x = 8;
	pixel_y = -3
	},
/obj/item/weapon/reagent_containers/pill/LSD{
	pixel_x = -7;
	pixel_y = 10
	},
/obj/item/weapon/reagent_containers/pill/methylphenidate,
/turf/simulated/floor{
	icon_state = "white"
	},
/area/agrospheregarden)
"ag" = (
/obj/structure/table/glass,
/obj/item/weapon/reagent_containers/pill/happy{
	pixel_x = 7;
	pixel_y = 5
	},
/obj/item/weapon/reagent_containers/pill/happy,
/obj/item/weapon/storage/pill_bottle/happy{
	pixel_x = -6;
	pixel_y = 8
	},
/obj/item/weapon/storage/pill_bottle/citalopram,
/obj/item/weapon/reagent_containers/syringe/antitoxin,
/obj/item/weapon/disk/research_points,
/turf/simulated/floor{
	icon_state = "white"
	},
/area/agrospheregarden)
"ah" = (
/obj/machinery/chem_master,
/turf/simulated/floor{
	icon_state = "white"
	},
/area/agrospheregarden)
"ai" = (
/obj/item/toy/figure/chemist,
/turf/simulated/floor{
	icon_state = "white"
	},
/area/agrospheregarden)
"aj" = (
/obj/item/weapon/reagent_containers/pill/paracetamol{
	pixel_x = 12;
	pixel_y = 6
	},
/obj/item/weapon/spacecash/c500{
	pixel_x = -2;
	pixel_y = -7
	},
/obj/item/weapon/spacecash/c1000{
	pixel_x = 11;
	pixel_y = 5
	},
/obj/item/weapon/spacecash/c1000,
/obj/item/weapon/spacecash/c200{
	pixel_y = 9
	},
/obj/item/weapon/spacecash/c500{
	pixel_x = -12;
	pixel_y = 6
	},
/obj/effect/decal/cleanable/vomit{
	icon_state = "vomittox_2"
	},
/obj/effect/decal/remains/human,
/obj/item/clothing/suit/storage/labcoat/mad,
/obj/item/clothing/head/cakehat,
/turf/simulated/floor{
	icon_state = "white"
	},
/area/agrospheregarden)
"ak" = (
/obj/item/weapon/reagent_containers/pill/LSD{
	pixel_x = 7;
	pixel_y = 9
	},
/obj/item/weapon/reagent_containers/pill/LSD{
	pixel_y = 5
	},
/obj/item/weapon/reagent_containers/pill/LSD{
	pixel_x = 4;
	pixel_y = -3
	},
/turf/simulated/floor{
	icon_state = "white"
	},
/area/agrospheregarden)
"al" = (
/obj/structure/table/glass,
/obj/machinery/kitchen_machine/microwave,
/turf/simulated/floor{
	icon_state = "white"
	},
/area/agrospheregarden)
"am" = (
/obj/structure/grille,
/obj/structure/window/reinforced{
	dir = 5
	},
/turf/simulated/floor/plating,
/area/agrospheregarden)
"an" = (
/obj/structure/table/glass,
/obj/item/weapon/storage/firstaid/toxin,
/obj/item/weapon/reagent_containers/hypospray,
/turf/simulated/floor{
	icon_state = "white"
	},
/area/agrospheregarden)
"ao" = (
/obj/item/weapon/reagent_containers/pill/methylphenidate,
/turf/simulated/floor{
	icon_state = "white"
	},
/area/agrospheregarden)
"ap" = (
/obj/machinery/hydroponics/constructable,
/turf/simulated/floor{
	icon_state = "white"
	},
/area/agrospheregarden)
"aq" = (
/turf/simulated/floor{
	icon_state = "white"
	},
/area/agrospheregarden)
"ar" = (
/obj/structure/table/glass,
/obj/item/weapon/reagent_containers/food/snacks/dionaroast,
/obj/item/weapon/kitchenknife/plastic,
/turf/simulated/floor{
	icon_state = "white"
	},
/area/agrospheregarden)
"as" = (
/obj/machinery/hydroponics/constructable,
/obj/item/weapon/reagent_containers/food/snacks/grown/ambrosiadeus,
/turf/simulated/floor{
	icon_state = "white"
	},
/area/agrospheregarden)
"at" = (
/obj/machinery/hydroponics/constructable,
/obj/item/weapon/reagent_containers/food/snacks/grown/ambrosiavulgaris,
/turf/simulated/floor{
	icon_state = "white"
	},
/area/agrospheregarden)
"au" = (
/obj/machinery/light{
	dir = 8
	},
/obj/machinery/hydroponics/constructable,
/obj/item/weapon/reagent_containers/food/snacks/grown/ambrosiavulgaris,
/turf/simulated/floor{
	icon_state = "white"
	},
/area/agrospheregarden)
"av" = (
/obj/machinery/light{
	dir = 4
	},
/obj/machinery/hydroponics/constructable,
/obj/item/weapon/reagent_containers/food/snacks/grown/ambrosiadeus,
/turf/simulated/floor{
	icon_state = "white"
	},
/area/agrospheregarden)
"aw" = (
/obj/machinery/hydroponics/constructable,
/obj/item/weapon/grown/deathnettle,
/turf/simulated/floor{
	icon_state = "white"
	},
/area/agrospheregarden)
"ax" = (
/obj/item/seeds/ambrosiadeusseed,
/obj/item/seeds/ambrosiadeusseed,
/obj/item/seeds/ambrosiadeusseed,
/obj/item/seeds/ambrosiavulgarisseed,
/obj/item/seeds/ambrosiavulgarisseed,
/obj/item/seeds/walkingmushroommycelium,
/obj/structure/closet/crate,
/obj/item/seeds/vale,
/obj/item/seeds/surik,
/turf/simulated/floor{
	icon_state = "white"
	},
/area/agrospheregarden)
"ay" = (
/obj/item/weapon/hatchet,
/obj/item/weapon/pestspray,
/obj/item/weapon/reagent_containers/spray/plantbgone,
/turf/simulated/floor{
	icon_state = "white"
	},
/area/agrospheregarden)
"az" = (
/obj/structure/shuttle/engine/heater,
/obj/structure/window/reinforced{
	dir = 4
	},
/obj/structure/window/reinforced{
	dir = 1
	},
/obj/structure/window/reinforced{
	dir = 8;
	req_access = list(72)
	},
/turf/simulated/floor/plating,
/area/agrospheregarden)
"aA" = (
/obj/machinery/door/airlock/external,
/turf/simulated/floor/plating,
/area/agrospheregarden)
"aB" = (
/obj/structure/shuttle/engine/propulsion,
/turf/simulated/floor/plating,
/area/agrospheregarden)
"aC" = (
/turf/simulated/floor/plating,
/area/agrospheregarden)
"aD" = (
/obj/structure/shuttle/engine/propulsion{
	dir = 1
	},
/turf/simulated/floor/plating,
/area/agrospheregarden)
"aE" = (
/turf/simulated/floor/grass,
/area/agrospheregarden)
"aF" = (
/obj/item/weapon/reagent_containers/food/snacks/grown/thaadrabloom,
/turf/simulated/floor/grass,
/area/agrospheregarden)
"aG" = (
/obj/structure/flora/ausbushes/lavendergrass,
/turf/simulated/floor/grass,
/area/agrospheregarden)
"aH" = (
/obj/machinery/light{
	dir = 8
	},
/turf/simulated/floor/grass,
/area/agrospheregarden)
"aI" = (
/obj/item/weapon/reagent_containers/food/snacks/grown/harebell,
/turf/simulated/floor/grass,
/area/agrospheregarden)
"aJ" = (
/obj/structure/flora/ausbushes/lavendergrass,
/obj/machinery/light{
	dir = 4
	},
/turf/simulated/floor/grass,
/area/agrospheregarden)
"aK" = (
/obj/structure/shuttle/engine/propulsion{
	dir = 8
	},
/turf/simulated/floor/plating,
/area/agrospheregarden)
"aL" = (
/obj/structure/shuttle/engine/heater{
	dir = 8
	},
/obj/structure/window/reinforced{
	dir = 1
	},
/obj/structure/window/reinforced{
	dir = 4
	},
/obj/structure/window/reinforced,
/turf/simulated/floor/plating,
/area/agrospheregarden)
"aM" = (
/obj/item/weapon/reagent_containers/food/snacks/grown/mtear,
/turf/simulated/floor/grass,
/area/agrospheregarden)
"aN" = (
/obj/structure/flora/junglebush/c,
/turf/simulated/floor/grass,
/area/agrospheregarden)
"aO" = (
/obj/structure/flora/tree/jungle,
/turf/simulated/floor/grass,
/area/agrospheregarden)
"aP" = (
/obj/structure/shuttle/engine/heater{
	dir = 4
	},
/obj/structure/window/reinforced{
	dir = 1
	},
/obj/structure/window/reinforced{
	dir = 8;
	req_access = list(72)
	},
/obj/structure/window/reinforced,
/turf/simulated/floor/plating,
/area/agrospheregarden)
"aQ" = (
/obj/structure/shuttle/engine/propulsion{
	dir = 4
	},
/turf/simulated/floor/plating,
/area/agrospheregarden)
"aR" = (
/obj/item/weapon/reagent_containers/food/snacks/grown/mushroom/chanterelle,
/turf/simulated/floor/grass,
/area/agrospheregarden)
"aS" = (
/obj/structure/flora/junglebush/large,
/turf/simulated/floor/grass,
/area/agrospheregarden)
"aT" = (
/obj/item/weapon/reagent_containers/food/snacks/grown/mushroom/chanterelle{
	pixel_x = -15;
	pixel_y = 15
	},
/turf/simulated/floor/grass,
/area/agrospheregarden)
"aU" = (
/obj/structure/flora/tree/jungle/small,
/turf/simulated/floor/grass,
/area/agrospheregarden)
"aV" = (
/obj/structure/flora/ausbushes/lavendergrass,
/obj/machinery/light{
	dir = 8
	},
/turf/simulated/floor/grass,
/area/agrospheregarden)
"aW" = (
/obj/item/weapon/reagent_containers/food/snacks/grown/thaadrabloom{
	pixel_x = 6;
	pixel_y = -5
	},
/turf/simulated/floor/grass,
/area/agrospheregarden)
"aX" = (
/obj/item/weapon/reagent_containers/food/snacks/grown/mushroom/libertycap,
/turf/simulated/floor/grass,
/area/agrospheregarden)
"aY" = (
/obj/machinery/light{
	dir = 4
	},
/obj/item/weapon/reagent_containers/food/snacks/grown/thaadrabloom,
/turf/simulated/floor/grass,
/area/agrospheregarden)
"aZ" = (
/obj/structure/flora/ausbushes/lavendergrass,
/obj/item/weapon/reagent_containers/food/snacks/grown/mushroom/libertycap,
/turf/simulated/floor/grass,
/area/agrospheregarden)
"ba" = (
/obj/item/weapon/reagent_containers/food/snacks/grown/mushroom/libertycap{
	pixel_x = -20;
	pixel_y = 10
	},
/turf/simulated/floor/grass,
/area/agrospheregarden)
"bb" = (
/obj/structure/flora/ausbushes/lavendergrass,
/obj/structure/flora/tree/jungle/small,
/turf/simulated/floor/grass,
/area/agrospheregarden)
"bc" = (
/obj/item/weapon/reagent_containers/food/snacks/grown/harebell{
	pixel_x = 6;
	pixel_y = 7
	},
/turf/simulated/floor/grass,
/area/agrospheregarden)
"bd" = (
/obj/machinery/light{
	dir = 4
	},
/turf/simulated/floor/grass,
/area/agrospheregarden)

(1,1,1) = {"
aa
aa
aa
aa
aa
aa
aa
aa
aa
aa
aa
aa
aa
aa
aa
aa
aa
aa
aa
aa
aa
aa
aa
aa
aa
aa
aa
aa
aa
aa
aa
aa
aa
aa
aa
aa
aa
aa
aa
aa
aa
aa
"}
(2,1,1) = {"
aa
aa
aa
aa
aa
aa
aa
aa
aa
aa
aa
aa
aa
aa
aa
aa
aa
aa
aa
aa
aa
aa
aa
aa
aa
aa
aa
aa
aa
aa
aa
aa
aa
aa
aa
aa
aa
aa
aa
aa
aa
aa
"}
(3,1,1) = {"
aa
aa
aa
aa
aa
aa
aa
aa
aa
aa
aa
aa
aa
aa
aa
aa
aa
aa
aa
aa
aa
aa
aa
aa
aa
aa
aa
aa
aa
aa
aa
aa
aa
aa
aa
aa
aa
aa
aa
aa
aa
aa
"}
(4,1,1) = {"
aa
aa
aa
aa
aa
aa
aa
aa
aa
aa
aa
aa
aa
aa
aa
aa
aa
aa
aa
aa
aa
aa
aK
aa
aa
aa
aa
aa
aK
aa
aa
aa
aa
aa
aa
aa
aa
aa
aa
aa
aa
aa
"}
(5,1,1) = {"
aa
aa
aa
aa
aa
aa
aa
aa
aa
aa
aa
aa
aa
aa
aa
aa
aa
aa
aa
aa
aa
aa
aL
am
am
am
am
am
aL
aa
aa
aa
aa
aa
aa
aa
aa
aa
aa
aa
aa
aa
"}
(6,1,1) = {"
aa
aa
aa
aa
aa
aa
aa
aa
aa
aa
aa
aa
aa
aa
aa
aa
aa
aa
aa
aa
aa
aa
ad
am
aE
aV
aI
am
ad
aa
aa
aa
aa
aa
aa
aa
aa
aa
aa
aa
aa
aa
"}
(7,1,1) = {"
aa
aa
aa
aa
aa
aa
aa
aa
aa
aa
aa
aa
aa
aa
aa
aa
aa
aa
aa
aa
aa
am
am
aE
aS
aE
aN
aE
am
am
aa
aa
aa
aa
aa
aa
aa
aa
aa
aa
aa
aa
"}
(8,1,1) = {"
aa
aa
aa
aa
aa
aa
aa
aa
aa
aa
aa
aa
aa
aa
aa
aa
aa
aa
aa
aa
am
am
aM
aE
aS
aE
aE
aE
aS
am
am
aa
aa
aa
aa
aa
aa
aa
aa
aa
aa
aa
"}
(9,1,1) = {"
aa
aa
aa
aa
aa
aa
aa
aa
aa
aa
aa
aa
aa
aa
aa
aa
aa
aa
aa
am
am
aH
aE
aE
aE
aE
aE
aO
aE
aH
am
am
aa
aa
aa
aa
aa
aa
aa
aa
aa
aa
"}
(10,1,1) = {"
aa
aa
aa
ab
ac
ad
ad
am
ad
ad
ad
am
ad
ad
az
aB
aD
ac
am
am
aE
aE
aN
aO
aE
aE
aE
aE
aE
aS
aF
am
az
aB
aa
aa
aa
aa
aa
aa
aa
aa
"}
(11,1,1) = {"
aa
aa
aa
aa
ad
ad
ah
an
as
au
at
as
ax
ad
ad
ad
ad
ad
ad
aE
aE
aE
aE
aR
aT
aM
aE
aE
bb
aE
aE
aG
ad
ad
ad
ad
ad
aa
aa
aa
aa
aa
"}
(12,1,1) = {"
aa
aa
aa
aa
ad
ae
ai
ao
aq
aq
aq
aq
aq
aq
ad
aC
aC
ad
aE
aF
aG
aE
aE
aE
aG
aE
aE
aE
aE
bc
aN
aE
aE
ad
aC
aC
ad
aa
aa
aa
aa
aa
"}
(13,1,1) = {"
aa
aa
aa
aa
ad
af
aj
ap
ap
as
ap
aw
aq
aq
aA
aC
aC
aA
aE
aE
aE
aI
aE
aE
aE
aW
aG
aE
aE
aE
aE
aE
aE
aA
aC
aC
aA
aa
aa
aa
aa
aa
"}
(14,1,1) = {"
aa
aa
aa
aa
ad
ag
ak
aq
aq
aq
aq
aq
aq
aq
ad
aC
aC
ad
aE
aE
aE
aE
aE
aE
aU
aE
aE
aE
aE
aE
aE
aF
aE
ad
aC
aC
ad
aa
aa
aa
aa
aa
"}
(15,1,1) = {"
aa
aa
aa
aa
ad
ad
al
ar
at
av
as
at
ay
ad
ad
ad
ad
ad
ad
aE
aE
aE
aO
aE
aE
aG
aE
aE
aE
aO
aS
aE
ad
ad
ad
ad
ad
aa
aa
aa
aa
aa
"}
(16,1,1) = {"
aa
aa
aa
ab
ac
ad
ad
am
ad
ad
ad
am
ad
ad
az
aB
aD
ac
am
am
aE
aE
aN
aE
aG
aI
aE
aS
aE
aG
aE
am
az
aB
aa
aa
aa
aa
aa
aa
aa
aa
"}
(17,1,1) = {"
aa
aa
aa
aa
aa
aa
aa
aa
aa
aa
aa
aa
aa
aa
aa
aa
aa
aa
aa
am
am
aJ
aE
aE
aE
aX
aN
aE
aE
bd
am
am
aa
aa
aa
aa
aa
aa
aa
aa
aa
aa
"}
(18,1,1) = {"
aa
aa
aa
aa
aa
aa
aa
aa
aa
aa
aa
aa
aa
aa
aa
aa
aa
aa
aa
aa
am
am
aE
aE
aE
aO
aZ
aE
aM
am
am
aa
aa
aa
aa
aa
aa
aa
aa
aa
aa
aa
"}
(19,1,1) = {"
aa
aa
aa
aa
aa
aa
aa
aa
aa
aa
aa
aa
aa
aa
aa
aa
aa
aa
aa
aa
aa
am
am
aE
aG
aG
ba
aG
am
am
aa
aa
aa
aa
aa
aa
aa
aa
aa
aa
aa
aa
"}
(20,1,1) = {"
aa
aa
aa
aa
aa
aa
aa
aa
aa
aa
aa
aa
aa
aa
aa
aa
aa
aa
aa
aa
aa
aa
ad
am
aE
aY
aS
am
ad
aa
aa
aa
aa
aa
aa
aa
aa
aa
aa
aa
aa
aa
"}
(21,1,1) = {"
aa
aa
aa
aa
aa
aa
aa
aa
aa
aa
aa
aa
aa
aa
aa
aa
aa
aa
aa
aa
aa
aa
aP
am
am
am
am
am
aP
aa
aa
aa
aa
aa
aa
aa
aa
aa
aa
aa
aa
aa
"}
(22,1,1) = {"
aa
aa
aa
aa
aa
aa
aa
aa
aa
aa
aa
aa
aa
aa
aa
aa
aa
aa
aa
aa
aa
aa
aQ
aa
aa
aa
aa
aa
aQ
aa
aa
aa
aa
aa
aa
aa
aa
aa
aa
aa
aa
aa
"}
(23,1,1) = {"
aa
aa
aa
aa
aa
aa
aa
aa
aa
aa
aa
aa
aa
aa
aa
aa
aa
aa
aa
aa
aa
aa
aa
aa
aa
aa
aa
aa
aa
aa
aa
aa
aa
aa
aa
aa
aa
aa
aa
aa
aa
aa
"}
(24,1,1) = {"
aa
aa
aa
aa
aa
aa
aa
aa
aa
aa
aa
aa
aa
aa
aa
aa
aa
aa
aa
aa
aa
aa
aa
aa
aa
aa
aa
aa
aa
aa
aa
aa
aa
aa
aa
aa
aa
aa
aa
aa
aa
aa
"}
(25,1,1) = {"
aa
aa
aa
aa
aa
aa
aa
aa
aa
aa
aa
aa
aa
aa
aa
aa
aa
aa
aa
aa
aa
aa
aa
aa
aa
aa
aa
aa
aa
aa
aa
aa
aa
aa
aa
aa
aa
aa
aa
aa
aa
aa
"}
