//MAP CONVERTED BY dmm2tgm.py THIS HEADER COMMENT PREVENTS RECONVERSION, DO NOT REMOVE
"a" = (
/turf/environment/space,
/area/space)
"b" = (
/turf/simulated/wall/r_wall,
/area/space_structures/cloning_lab)
"c" = (
/obj/structure/rack,
/obj/item/weapon/circuitboard/cloning,
/obj/item/stack/cable_coil/random,
/obj/item/weapon/shard,
/turf/simulated/floor/plating,
/area/space_structures/cloning_lab)
"d" = (
/obj/machinery/light_construct/small{
	dir = 1
	},
/obj/machinery/power/apc{
	dir = 1;
	name = "Cloning Facility APC";
	pixel_y = 32
	},
/turf/simulated/floor/plating,
/area/space_structures/cloning_lab)
"e" = (
/turf/simulated/floor/plating,
/area/space_structures/cloning_lab)
"f" = (
/obj/effect/decal/cleanable/dirt,
/turf/simulated/floor/plating,
/area/space_structures/cloning_lab)
"g" = (
/obj/structure/reagent_dispensers/fueltank,
/turf/simulated/floor/plating,
/area/space_structures/cloning_lab)
"h" = (
/obj/structure/reagent_dispensers/watertank,
/turf/simulated/floor/plating,
/area/space_structures/cloning_lab)
"i" = (
/obj/structure/window/fulltile/reinforced{
	grilled = 1;
	icon_state = "gr_window_reinforced"
	},
/turf/simulated/floor/plating,
/area/space_structures/cloning_lab)
"j" = (
/obj/machinery/door/airlock/maintenance,
/turf/simulated/floor/plating,
/area/space_structures/cloning_lab)
"k" = (
/obj/structure/table,
/obj/item/weapon/storage/firstaid/regular,
/obj/item/device/healthanalyzer{
	desc = "A prototype model of a hand-held body scanner able to distinguish vital signs of the subject.";
	name = "Prototype Health Analyzer"
	},
/turf/simulated/floor{
	dir = 9;
	icon_state = "whitepurple"
	},
/area/space_structures/cloning_lab)
"l" = (
/obj/structure/table,
/turf/simulated/floor{
	dir = 1;
	icon_state = "whitepurple"
	},
/area/space_structures/cloning_lab)
"m" = (
/obj/structure/table,
/obj/item/weapon/storage/box/syringes,
/turf/simulated/floor{
	dir = 1;
	icon_state = "whitepurple"
	},
/area/space_structures/cloning_lab)
"n" = (
/obj/structure/table,
/obj/structure/bedsheetbin,
/obj/machinery/light{
	dir = 1
	},
/turf/simulated/floor{
	dir = 1;
	icon_state = "whitepurple"
	},
/area/space_structures/cloning_lab)
"o" = (
/turf/simulated/floor{
	dir = 5;
	icon_state = "whitepurple"
	},
/area/space_structures/cloning_lab)
"p" = (
/obj/structure/sign/nanotrasen,
/turf/simulated/wall/r_wall,
/area/space_structures/cloning_lab)
"q" = (
/obj/random/vending/snack,
/turf/simulated/floor{
	dir = 9;
	icon_state = "brown"
	},
/area/space_structures/cloning_lab)
"r" = (
/obj/effect/decal/cleanable/dirt,
/turf/simulated/floor/wood{
	icon_state = "wood4"
	},
/area/space_structures/cloning_lab)
"s" = (
/obj/structure/sign/directions/science{
	dir = 8
	},
/turf/simulated/wall/r_wall,
/area/space_structures/cloning_lab)
"t" = (
/obj/effect/decal/cleanable/blood,
/obj/effect/decal/remains/human,
/turf/simulated/floor/wood{
	icon_state = "wood4"
	},
/area/space_structures/cloning_lab)
"u" = (
/obj/machinery/iv_drip,
/turf/simulated/floor/wood{
	icon_state = "wood4"
	},
/area/space_structures/cloning_lab)
"v" = (
/obj/effect/decal/cleanable/dirt,
/obj/machinery/light/small{
	dir = 4
	},
/obj/item/weapon/bedsheet/purple,
/obj/structure/stool/bed,
/turf/simulated/floor/wood{
	icon_state = "wood4"
	},
/area/space_structures/cloning_lab)
"w" = (
/obj/effect/decal/turf_decal{
	dir = 8;
	icon_state = "warn"
	},
/turf/simulated/floor{
	dir = 10;
	icon_state = "whitepurple"
	},
/area/space_structures/cloning_lab)
"x" = (
/obj/structure/sign/departments/science,
/turf/simulated/wall/r_wall,
/area/space_structures/cloning_lab)
"y" = (
/turf/simulated/floor/wood{
	icon_state = "wood4"
	},
/area/space_structures/cloning_lab)
"z" = (
/obj/effect/decal/cleanable/dirt,
/obj/effect/decal/cleanable/dirt,
/turf/simulated/floor{
	dir = 4;
	icon_state = "browncorner"
	},
/area/space_structures/cloning_lab)
"A" = (
/obj/effect/decal/turf_decal/set_damaged,
/turf/simulated/floor/plating/airless,
/area/space_structures/cloning_lab)
"B" = (
/obj/structure/stool/bed/chair/comfy/white{
	dir = 8
	},
/turf/simulated/floor/wood{
	icon_state = "wood4"
	},
/area/space_structures/cloning_lab)
"C" = (
/obj/machinery/door/airlock/research/glass{
	name = "Reabilitaion Chamber";
	dir = 4
	},
/turf/simulated/floor/wood{
	icon_state = "wood4"
	},
/area/space_structures/cloning_lab)
"D" = (
/obj/structure/stool/bed/chair,
/turf/simulated/floor{
	icon_state = "whitechoco"
	},
/area/space_structures/cloning_lab)
"E" = (
/obj/machinery/door/airlock/research{
	name = "Cloning Facility";
	dir = 4
	},
/turf/simulated/floor{
	icon_state = "whitepurplefull"
	},
/area/space_structures/cloning_lab)
"F" = (
/obj/effect/decal/cleanable/dirt,
/obj/effect/decal/cleanable/dirt,
/obj/item/weapon/book/manual/wiki/medical_genetics,
/obj/structure/table,
/turf/simulated/floor/wood{
	icon_state = "wood4"
	},
/area/space_structures/cloning_lab)
"G" = (
/obj/effect/decal/cleanable/dirt,
/obj/machinery/light/small{
	dir = 4
	},
/turf/simulated/floor/wood{
	icon_state = "wood4"
	},
/area/space_structures/cloning_lab)
"H" = (
/obj/machinery/clonepod,
/turf/simulated/floor{
	icon_state = "whitepurple"
	},
/area/space_structures/cloning_lab)
"I" = (
/obj/structure/computerframe{
	anchored = 1
	},
/obj/machinery/light,
/turf/simulated/floor{
	icon_state = "whitepurple"
	},
/area/space_structures/cloning_lab)
"J" = (
/obj/machinery/dna_scannernew,
/turf/simulated/floor{
	icon_state = "whitepurple"
	},
/area/space_structures/cloning_lab)
"K" = (
/obj/structure/table,
/obj/item/device/flashlight/lamp,
/turf/simulated/floor{
	icon_state = "whitepurple"
	},
/area/space_structures/cloning_lab)
"L" = (
/obj/structure/table,
/obj/item/weapon/disk/research_points,
/obj/item/weapon/paper/cloning_lab,
/turf/simulated/floor{
	icon_state = "whitepurple"
	},
/area/space_structures/cloning_lab)
"M" = (
/obj/structure/filingcabinet/chestdrawer,
/obj/item/weapon/paper/cloning_log,
/turf/simulated/floor{
	icon_state = "whitepurple"
	},
/area/space_structures/cloning_lab)
"N" = (
/obj/effect/decal/turf_decal{
	dir = 8;
	icon_state = "warn"
	},
/turf/simulated/floor{
	dir = 9;
	icon_state = "whitepurple"
	},
/area/space_structures/cloning_lab)
"O" = (
/obj/effect/decal/cleanable/dirt,
/turf/simulated/floor{
	dir = 8;
	icon_state = "brown"
	},
/area/space_structures/cloning_lab)
"P" = (
/obj/effect/decal/turf_decal{
	dir = 8;
	icon_state = "warn"
	},
/turf/simulated/floor{
	dir = 8;
	icon_state = "whitepurple"
	},
/area/space_structures/cloning_lab)
"Q" = (
/turf/simulated/floor{
	dir = 8;
	icon_state = "brown"
	},
/area/space_structures/cloning_lab)
"R" = (
/turf/simulated/floor{
	dir = 6;
	icon_state = "whitepurple"
	},
/area/space_structures/cloning_lab)
"S" = (
/obj/machinery/door/airlock/research/glass{
	name = "Reabilitaion Chamber";
	dir = 4
	},
/turf/simulated/floor{
	icon_state = "whitepurplefull"
	},
/area/space_structures/cloning_lab)
"T" = (
/obj/effect/decal/cleanable/dirt,
/turf/simulated/floor{
	dir = 5;
	icon_state = "brown"
	},
/area/space_structures/cloning_lab)
"U" = (
/turf/simulated/floor{
	icon_state = "whitechoco"
	},
/area/space_structures/cloning_lab)
"W" = (
/turf/simulated/floor{
	dir = 1;
	icon_state = "whitepurplecorner"
	},
/area/space_structures/cloning_lab)
"X" = (
/turf/simulated/floor{
	dir = 1;
	icon_state = "whitepurple"
	},
/area/space_structures/cloning_lab)
"Y" = (
/turf/simulated/floor{
	dir = 4;
	icon_state = "whitepurple"
	},
/area/space_structures/cloning_lab)

(1,1,1) = {"
a
a
a
a
a
i
i
i
i
i
"}
(2,1,1) = {"
a
a
a
a
a
i
t
B
F
i
"}
(3,1,1) = {"
a
a
a
a
a
i
u
r
r
i
"}
(4,1,1) = {"
a
a
a
a
a
b
v
y
G
b
"}
(5,1,1) = {"
a
a
a
a
a
b
b
C
b
b
"}
(6,1,1) = {"
a
a
a
a
a
a
b
y
b
a
"}
(7,1,1) = {"
a
a
a
a
a
b
b
S
b
b
"}
(8,1,1) = {"
a
a
a
a
b
b
N
P
w
i
"}
(9,1,1) = {"
a
a
a
a
i
k
W
U
H
i
"}
(10,1,1) = {"
a
a
a
a
i
l
U
D
I
b
"}
(11,1,1) = {"
b
b
b
b
b
m
U
U
J
b
"}
(12,1,1) = {"
b
c
f
f
b
n
U
U
K
i
"}
(13,1,1) = {"
b
d
e
f
j
X
U
D
L
i
"}
(14,1,1) = {"
b
e
g
h
b
X
U
U
M
b
"}
(15,1,1) = {"
b
b
b
b
b
o
Y
Y
R
b
"}
(16,1,1) = {"
a
a
a
a
b
p
x
E
b
b
"}
(17,1,1) = {"
a
a
a
a
i
q
Q
O
A
b
"}
(18,1,1) = {"
a
a
a
a
i
T
z
A
A
A
"}
(19,1,1) = {"
a
a
a
a
b
s
A
A
a
a
"}
(20,1,1) = {"
a
a
a
a
a
b
i
a
a
a
"}
