"aa" = (/turf/space,/area/space)
"ab" = (/turf/simulated/wall/r_wall,/area/space_structures/cloning_lab)
"ac" = (/obj/structure/rack,/obj/item/weapon/circuitboard/cloning,/obj/item/stack/cable_coil/random,/obj/item/weapon/shard,/turf/simulated/floor/plating,/area/space_structures/cloning_lab)
"ad" = (/obj/machinery/light_construct/small{dir = 1},/obj/machinery/power/apc{dir = 1; name = "Cloning Facility APC"; pixel_y = 32},/turf/simulated/floor/plating,/area/space_structures/cloning_lab)
"ae" = (/turf/simulated/floor/plating,/area/space_structures/cloning_lab)
"af" = (/obj/effect/decal/cleanable/dirt,/turf/simulated/floor/plating,/area/space_structures/cloning_lab)
"ag" = (/obj/structure/reagent_dispensers/fueltank,/turf/simulated/floor/plating,/area/space_structures/cloning_lab)
"ah" = (/obj/structure/reagent_dispensers/watertank,/turf/simulated/floor/plating,/area/space_structures/cloning_lab)
"ai" = (/obj/structure/grille,/obj/structure/window/reinforced{dir = 5},/turf/simulated/floor/plating,/area/space_structures/cloning_lab)
"aj" = (/obj/machinery/door/airlock/maintenance,/turf/simulated/floor/plating,/area/space_structures/cloning_lab)
"ak" = (/obj/structure/table,/obj/item/weapon/storage/firstaid/regular,/obj/item/device/healthanalyzer{desc = "A prototype model of a hand-held body scanner able to distinguish vital signs of the subject."; name = "Prototype Health Analyzer"},/turf/simulated/floor{dir = 1; icon_state = "white"},/area/space_structures/cloning_lab)
"al" = (/obj/structure/table,/turf/simulated/floor{dir = 1; icon_state = "white"},/area/space_structures/cloning_lab)
"am" = (/obj/structure/table,/obj/item/weapon/storage/box/syringes,/turf/simulated/floor{dir = 1; icon_state = "white"},/area/space_structures/cloning_lab)
"an" = (/obj/structure/table,/obj/structure/bedsheetbin,/obj/machinery/light{dir = 1},/turf/simulated/floor{dir = 1; icon_state = "white"},/area/space_structures/cloning_lab)
"ao" = (/turf/simulated/floor{dir = 1; icon_state = "white"},/area/space_structures/cloning_lab)
"ap" = (/obj/structure/sign/nanotrasen,/turf/simulated/wall/r_wall,/area/space_structures/cloning_lab)
"aq" = (/obj/random/vending/snack,/turf/simulated/floor,/area/space_structures/cloning_lab)
"ar" = (/obj/effect/decal/cleanable/dirt,/turf/simulated/floor,/area/space_structures/cloning_lab)
"as" = (/obj/structure/sign/directions/science{dir = 8},/turf/simulated/wall/r_wall,/area/space_structures/cloning_lab)
"at" = (/obj/structure/computerframe{anchored = 1},/turf/simulated/floor{dir = 1; icon_state = "white"},/area/space_structures/cloning_lab)
"au" = (/obj/machinery/computer/scan_consolenew,/turf/simulated/floor{dir = 1; icon_state = "white"},/area/space_structures/cloning_lab)
"av" = (/obj/effect/decal/cleanable/dirt,/obj/item/weapon/storage/toolbox/emergency,/turf/simulated/floor/plating,/area/space_structures/cloning_lab)
"aw" = (/turf/simulated/floor{dir = 8; icon_state = "warnwhite"},/area/space_structures/cloning_lab)
"ax" = (/obj/structure/sign/departments/science,/turf/simulated/wall/r_wall,/area/space_structures/cloning_lab)
"ay" = (/turf/simulated/floor,/area/space_structures/cloning_lab)
"az" = (/obj/effect/decal/cleanable/dirt,/obj/effect/decal/cleanable/dirt,/turf/simulated/floor,/area/space_structures/cloning_lab)
"aA" = (/turf/simulated/floor/plating/airless,/area/space_structures/cloning_lab)
"aB" = (/obj/structure/flora/pottedplant/unusual,/obj/machinery/light{dir = 1},/turf/simulated/floor{dir = 1; icon_state = "white"},/area/space_structures/cloning_lab)
"aC" = (/obj/machinery/door/airlock/research/glass{name = "Reabilitaion Chamber"},/turf/simulated/floor,/area/space_structures/cloning_lab)
"aD" = (/obj/structure/table,/obj/item/weapon/dnainjector/stuttmut,/turf/simulated/floor{dir = 1; icon_state = "white"},/area/space_structures/cloning_lab)
"aE" = (/obj/structure/stool/bed/chair{dir = 4},/turf/simulated/floor{dir = 1; icon_state = "white"},/area/space_structures/cloning_lab)
"aF" = (/obj/structure/stool/bed/chair{dir = 1},/turf/simulated/floor{dir = 1; icon_state = "white"},/area/space_structures/cloning_lab)
"aG" = (/obj/structure/disposalpipe/segment{dir = 4; icon_state = "pipe-c"},/turf/simulated/floor{dir = 1; icon_state = "white"},/area/space_structures/cloning_lab)
"aH" = (/obj/machinery/clonepod,/turf/simulated/floor{dir = 1; icon_state = "white"},/area/space_structures/cloning_lab)
"aI" = (/obj/structure/computerframe{anchored = 1},/obj/machinery/light,/turf/simulated/floor{dir = 1; icon_state = "white"},/area/space_structures/cloning_lab)
"aJ" = (/obj/machinery/dna_scannernew,/turf/simulated/floor{dir = 1; icon_state = "white"},/area/space_structures/cloning_lab)
"aK" = (/obj/structure/table,/obj/item/device/flashlight/lamp,/turf/simulated/floor{dir = 1; icon_state = "white"},/area/space_structures/cloning_lab)
"aL" = (/obj/structure/table,/obj/item/weapon/disk/research_points,/obj/item/weapon/paper/cloning_lab,/turf/simulated/floor{dir = 1; icon_state = "white"},/area/space_structures/cloning_lab)
"aM" = (/obj/structure/filingcabinet/chestdrawer,/obj/item/weapon/paper/cloning_log,/turf/simulated/floor{dir = 1; icon_state = "white"},/area/space_structures/cloning_lab)
"aN" = (/obj/structure/disposalpipe/segment{dir = 4},/turf/simulated/floor{dir = 1; icon_state = "white"},/area/space_structures/cloning_lab)
"aO" = (/obj/structure/disposalpipe/segment{dir = 4},/turf/simulated/floor,/area/space_structures/cloning_lab)
"aP" = (/obj/machinery/door/airlock/research/glass{name = "Genetic Research"},/obj/structure/disposalpipe/segment{dir = 4},/turf/simulated/floor,/area/space_structures/cloning_lab)
"aQ" = (/obj/structure/disposalpipe/segment{dir = 4},/obj/machinery/door/airlock/research/glass{name = "Genetic Research"},/turf/simulated/floor,/area/space_structures/cloning_lab)
"aR" = (/obj/structure/disposalpipe/segment{dir = 4},/turf/simulated/floor{dir = 8; icon_state = "warnwhite"},/area/space_structures/cloning_lab)
"aS" = (/obj/structure/stool/bed/chair,/obj/structure/disposalpipe/segment{dir = 4},/turf/simulated/floor{dir = 1; icon_state = "white"},/area/space_structures/cloning_lab)
"aT" = (/obj/machinery/door/airlock/research{name = "Cloning Facility"},/obj/structure/disposalpipe/segment{dir = 4},/turf/simulated/floor,/area/space_structures/cloning_lab)
"aU" = (/obj/effect/decal/cleanable/dirt,/obj/structure/disposalpipe/segment{dir = 4},/turf/simulated/floor,/area/space_structures/cloning_lab)
"aV" = (/obj/structure/disposalpipe/segment{dir = 4},/turf/simulated/floor/plating/airless,/area/space_structures/cloning_lab)
"aW" = (/obj/machinery/disposal,/obj/structure/disposalpipe/trunk{dir = 1},/turf/simulated/floor{dir = 1; icon_state = "white"},/area/space_structures/cloning_lab)
"aX" = (/obj/structure/table,/obj/item/weapon/dnainjector/insulation,/turf/simulated/floor{dir = 1; icon_state = "white"},/area/space_structures/cloning_lab)
"aY" = (/obj/structure/table,/obj/item/weapon/storage/pouch/medical_supply,/turf/simulated/floor{dir = 1; icon_state = "white"},/area/space_structures/cloning_lab)
"aZ" = (/obj/structure/table,/obj/item/weapon/storage/firstaid/toxin,/obj/machinery/light,/turf/simulated/floor{dir = 1; icon_state = "white"},/area/space_structures/cloning_lab)
"ba" = (/obj/structure/table,/obj/item/weapon/reagent_containers/glass/bottle/mutagen,/obj/item/weapon/reagent_containers/glass/bottle/toxin{pixel_x = 7; pixel_y = 3},/turf/simulated/floor{dir = 1; icon_state = "white"},/area/space_structures/cloning_lab)
"bb" = (/obj/effect/decal/cleanable/dirt,/obj/structure/closet/emcloset/legacy,/obj/item/clothing/suit/space/syndicate/civilian,/obj/item/clothing/head/helmet/space/syndicate/civilian,/turf/simulated/floor,/area/space_structures/cloning_lab)
"bc" = (/obj/effect/decal/cleanable/dirt,/obj/item/weapon/bedsheet/purple,/obj/structure/stool/bed,/turf/simulated/floor,/area/space_structures/cloning_lab)
"bd" = (/obj/effect/decal/remains/human,/turf/simulated/floor,/area/space_structures/cloning_lab)
"be" = (/obj/machinery/light/small{dir = 4},/turf/simulated/floor,/area/space_structures/cloning_lab)
"bf" = (/obj/structure/table,/obj/item/weapon/book/manual/wiki/medical_genetics,/turf/simulated/floor,/area/space_structures/cloning_lab)
"bg" = (/obj/structure/stool/bed/chair/comfy/teal,/turf/simulated/floor,/area/space_structures/cloning_lab)
"bh" = (/obj/machinery/iv_drip,/turf/simulated/floor,/area/space_structures/cloning_lab)
"bi" = (/obj/structure/survivor_cryopod/clone,/turf/simulated/floor{dir = 1; icon_state = "white"},/area/space_structures/cloning_lab)

(1,1,1) = {"
aaaaaaaaaaaaaaaaaaaaaaaaaaaaaaaaaaaaaaaaabababababaaaaaaaaaa
aaaaaaaaaaaaaaaaaaaaaaaaaaaaaaaaaaaaaaaaabacadaeabaaaaaaaaaa
aaaaaaaaaaaaaaaaaaaaaaaaaaaaaaaaaaaaaaaaabafaeagabaaaaaaaaaa
aaaaaaaaaaaaaaaaaaaaaaaaaaaaaaaaaaaaaaaaabavafahabaaaaaaaaaa
aaaaaaaaaaabababababababababaaaaaaabaiaiababajabababaiaiabaa
aaaaaaaaaaabalbiataBaJauaDababaaababakalamanaoaoaoapaqarasab
aaaaaaaaaaabaoaoaEaoaoaFaoarabababawaoaoaoaoaoaoaoaxayazaAai
aaaaaaaaaaabaGaNaNaNaNaNaNaOaPaOaQaRaNaSaNaNaSaNaNaTaUaVaVaa
aaaaaaaaaaabaWaoaoaXaYaZbabbabababawaHaIaJaKaLaMaoabaAaAaaaa
aaaaaaaaaaabababaCababababababaaabaiaiababaiaiababababaAaaaa
aaaaaaaaaaaaabayaybcabaaaaaaaaaaaaaaaaaaaaaaaaaaaaaaaaaaaaaa
aaaaaaaaaaaaabaybdbeabaaaaaaaaaaaaaaaaaaaaaaaaaaaaaaaaaaaaaa
aaaaaaaaaaaaaibfbgbhaiaaaaaaaaaaaaaaaaaaaaaaaaaaaaaaaaaaaaaa
aaaaaaaaaaaaaiaiaiaiaiaaaaaaaaaaaaaaaaaaaaaaaaaaaaaaaaaaaaaa
aaaaaaaaaaaaaaaaaaaaaaaaaaaaaaaaaaaaaaaaaaaaaaaaaaaaaaaaaaaa
aaaaaaaaaaaaaaaaaaaaaaaaaaaaaaaaaaaaaaaaaaaaaaaaaaaaaaaaaaaa
aaaaaaaaaaaaaaaaaaaaaaaaaaaaaaaaaaaaaaaaaaaaaaaaaaaaaaaaaaaa
aaaaaaaaaaaaaaaaaaaaaaaaaaaaaaaaaaaaaaaaaaaaaaaaaaaaaaaaaaaa
aaaaaaaaaaaaaaaaaaaaaaaaaaaaaaaaaaaaaaaaaaaaaaaaaaaaaaaaaaaa
aaaaaaaaaaaaaaaaaaaaaaaaaaaaaaaaaaaaaaaaaaaaaaaaaaaaaaaaaaaa
"}
