//MAP CONVERTED BY dmm2tgm.py THIS HEADER COMMENT PREVENTS RECONVERSION, DO NOT REMOVE
"aa" = (
/turf/space,
/area/space)
"ab" = (
/obj/structure/shuttle/engine/propulsion{
	dir = 1
	},
/turf/space,
/area/space_structures/collector_ship)
"ac" = (
/turf/space,
/turf/simulated/shuttle/wall{
	icon_state = "swall_f6"
	},
/area/space_structures/collector_ship)
"ad" = (
/turf/simulated/shuttle/wall{
	icon_state = "swall12"
	},
/area/space_structures/collector_ship)
"ae" = (
/turf/simulated/shuttle/wall{
	dir = 1;
	icon_state = "swallc3"
	},
/area/space_structures/collector_ship)
"af" = (
/obj/structure/shuttle/engine/heater{
	dir = 1;
	icon_state = "heater1"
	},
/obj/structure/window/phoronreinforced,
/obj/structure/window/phoronreinforced{
	dir = 8
	},
/turf/simulated/shuttle/floor{
	icon_state = "vwall12"
	},
/area/space_structures/collector_ship)
"ag" = (
/obj/structure/shuttle/engine/heater{
	dir = 1;
	icon_state = "heater1"
	},
/obj/structure/window/phoronreinforced,
/obj/structure/window/phoronreinforced{
	dir = 4
	},
/turf/simulated/shuttle/floor{
	icon_state = "vwall12"
	},
/area/space_structures/collector_ship)
"ah" = (
/turf/simulated/shuttle/wall{
	dir = 8;
	icon_state = "swallc3"
	},
/area/space_structures/collector_ship)
"ai" = (
/turf/space,
/turf/simulated/shuttle/wall{
	icon_state = "swall_s10"
	},
/area/space_structures/collector_ship)
"aj" = (
/turf/simulated/shuttle/wall{
	icon_state = "swall1"
	},
/area/space_structures/collector_ship)
"ak" = (
/obj/structure/closet/emcloset/legacy{
	desc = "It's a storage unit for emergency breathmasks and o2 tanks. This one looks particularly old.";
	name = "dusty emergency closet"
	},
/obj/machinery/light/small{
	dir = 1;
	light_color = "#8b008b"
	},
/turf/simulated/shuttle/floor{
	icon_state = "floor3"
	},
/area/space_structures/collector_ship)
"al" = (
/obj/structure/table/reinforced,
/obj/item/clothing/glasses/fluff/uzenwa_sissra_1,
/obj/item/stack/cable_coil,
/turf/simulated/shuttle/floor{
	icon_state = "floor2"
	},
/area/space_structures/collector_ship)
"am" = (
/obj/structure/table/reinforced,
/obj/item/weapon/weldingtool/hugetank,
/turf/simulated/shuttle/floor{
	icon_state = "floor2"
	},
/area/space_structures/collector_ship)
"an" = (
/turf/simulated/shuttle/wall{
	icon_state = "swall3"
	},
/area/space_structures/collector_ship)
"ao" = (
/obj/structure/table/reinforced,
/obj/item/xenos_claw,
/turf/simulated/shuttle/floor{
	icon_state = "floor3"
	},
/area/space_structures/collector_ship)
"ap" = (
/obj/structure/table/reinforced,
/obj/item/weapon/vending_refill/cola,
/obj/machinery/light{
	dir = 1
	},
/turf/simulated/shuttle/floor{
	icon_state = "floor3"
	},
/area/space_structures/collector_ship)
"aq" = (
/obj/structure/table/reinforced,
/obj/item/weapon/wirerod,
/obj/item/weapon/wrench,
/turf/simulated/shuttle/floor{
	icon_state = "floor3"
	},
/area/space_structures/collector_ship)
"as" = (
/turf/simulated/shuttle/floor{
	icon_state = "floor3"
	},
/area/space_structures/collector_ship)
"at" = (
/obj/machinery/door/unpowered/shuttle,
/turf/simulated/shuttle/floor{
	icon_state = "floor3"
	},
/area/space_structures/collector_ship)
"au" = (
/mob/living/simple_animal/hostile/mimic/crate,
/turf/simulated/shuttle/floor{
	icon_state = "floor4"
	},
/area/space_structures/collector_ship)
"av" = (
/obj/structure/rack,
/obj/item/weapon/scrap_lump,
/turf/simulated/shuttle/floor{
	icon_state = "floor4"
	},
/area/space_structures/collector_ship)
"aw" = (
/obj/structure/extinguisher_cabinet{
	pixel_x = -32
	},
/obj/structure/flora/pottedplant/smelly,
/turf/simulated/shuttle/floor{
	icon_state = "floor3"
	},
/area/space_structures/collector_ship)
"ax" = (
/obj/structure/flora/pottedplant/subterranean,
/turf/simulated/shuttle/floor{
	icon_state = "floor3"
	},
/area/space_structures/collector_ship)
"ay" = (
/obj/structure/window/phoronreinforced{
	dir = 6
	},
/obj/structure/grille,
/turf/simulated/shuttle/floor{
	icon_state = "vwall12"
	},
/area/space_structures/collector_ship)
"az" = (
/obj/structure/reagent_dispensers/coolanttank,
/turf/simulated/shuttle/floor{
	icon_state = "floor2"
	},
/area/space_structures/collector_ship)
"aA" = (
/obj/structure/reagent_dispensers/watertank/aqueous_foam_tank,
/turf/simulated/shuttle/floor{
	icon_state = "floor2"
	},
/area/space_structures/collector_ship)
"aB" = (
/obj/machinery/light{
	dir = 8
	},
/turf/simulated/shuttle/floor{
	icon_state = "floor3"
	},
/area/space_structures/collector_ship)
"aC" = (
/obj/item/weapon/bikehorn/rubberducky,
/obj/structure/rack,
/turf/simulated/shuttle/floor{
	icon_state = "floor4"
	},
/area/space_structures/collector_ship)
"aD" = (
/obj/structure/displaycase/broken,
/obj/item/weapon/shard{
	icon_state = "medium"
	},
/obj/item/weapon/gun/energy/laser/retro/jetsons,
/turf/simulated/shuttle/floor{
	icon_state = "floor4"
	},
/area/space_structures/collector_ship)
"aE" = (
/obj/effect/decal/remains/human,
/turf/simulated/shuttle/floor{
	icon_state = "floor2"
	},
/area/space_structures/collector_ship)
"aF" = (
/turf/simulated/shuttle/floor{
	icon_state = "floor2"
	},
/area/space_structures/collector_ship)
"aG" = (
/obj/structure/flora/pottedplant/sticky,
/turf/simulated/shuttle/floor{
	icon_state = "floor3"
	},
/area/space_structures/collector_ship)
"aH" = (
/obj/structure/table/reinforced,
/obj/machinery/light_construct/small,
/turf/simulated/shuttle/floor{
	icon_state = "floor2"
	},
/area/space_structures/collector_ship)
"aI" = (
/obj/structure/table/reinforced,
/obj/item/weapon/storage/belt/utility/atmostech,
/turf/simulated/shuttle/floor{
	icon_state = "floor2"
	},
/area/space_structures/collector_ship)
"aJ" = (
/obj/structure/barricade/wooden,
/obj/effect/spider/stickyweb,
/turf/simulated/shuttle/floor{
	icon_state = "floor3"
	},
/area/space_structures/collector_ship)
"aK" = (
/obj/structure/barricade/wooden,
/turf/simulated/shuttle/floor{
	icon_state = "floor3"
	},
/area/space_structures/collector_ship)
"aL" = (
/obj/structure/displaycase/broken,
/obj/item/weapon/shard,
/turf/simulated/shuttle/floor{
	icon_state = "floor4"
	},
/area/space_structures/collector_ship)
"aM" = (
/obj/machinery/light,
/turf/simulated/shuttle/floor{
	icon_state = "floor3"
	},
/area/space_structures/collector_ship)
"aN" = (
/obj/structure/window/phoronbasic{
	dir = 8
	},
/obj/structure/window/phoronbasic{
	dir = 4
	},
/obj/structure/window/phoronbasic{
	dir = 1
	},
/obj/structure/window/phoronbasic,
/mob/living/simple_animal/hostile/giant_spider,
/turf/simulated/floor/engine,
/area/space_structures/collector_ship)
"aO" = (
/turf/simulated/shuttle/wall{
	icon_state = "swall7"
	},
/area/space_structures/collector_ship)
"aP" = (
/turf/simulated/shuttle/wall{
	icon_state = "swall14"
	},
/area/space_structures/collector_ship)
"aQ" = (
/turf/simulated/shuttle/wall{
	dir = 1;
	icon_state = "swallc2"
	},
/area/space_structures/collector_ship)
"aR" = (
/obj/machinery/door/unpowered/shuttle,
/obj/effect/spider/stickyweb,
/turf/simulated/shuttle/floor{
	icon_state = "floor3"
	},
/area/space_structures/collector_ship)
"aS" = (
/turf/simulated/shuttle/wall{
	icon_state = "swallc3"
	},
/area/space_structures/collector_ship)
"aT" = (
/turf/space,
/turf/simulated/shuttle/wall{
	icon_state = "swall_s9"
	},
/area/space_structures/collector_ship)
"aU" = (
/turf/space,
/turf/simulated/shuttle/wall{
	icon_state = "swall_f5"
	},
/area/space_structures/collector_ship)
"aV" = (
/turf/simulated/shuttle/wall{
	icon_state = "swall11"
	},
/area/space_structures/collector_ship)
"aW" = (
/obj/structure/table/reinforced,
/obj/machinery/computer/libraryconsole/old,
/obj/effect/spider/stickyweb,
/turf/simulated/shuttle/floor,
/area/space_structures/collector_ship)
"aX" = (
/obj/effect/spider/stickyweb,
/turf/simulated/shuttle/floor{
	icon_state = "floor3"
	},
/area/space_structures/collector_ship)
"aY" = (
/mob/living/simple_animal/hostile/giant_spider/hunter,
/turf/simulated/shuttle/floor{
	icon_state = "floor3"
	},
/area/space_structures/collector_ship)
"aZ" = (
/obj/machinery/computer/reconstitutor/animal{
	dir = 8
	},
/turf/simulated/shuttle/floor,
/area/space_structures/collector_ship)
"bb" = (
/obj/structure/table/reinforced,
/obj/item/weapon/disk/research_points{
	pixel_x = -4;
	pixel_y = 7
	},
/obj/effect/spider/stickyweb,
/obj/machinery/light{
	dir = 8;
	status = 3
	},
/turf/simulated/shuttle/floor,
/area/space_structures/collector_ship)
"bc" = (
/obj/effect/decal/remains/human,
/obj/effect/decal/cleanable/blood,
/turf/simulated/shuttle/floor{
	icon_state = "floor3"
	},
/area/space_structures/collector_ship)
"bd" = (
/obj/machinery/computer/reconstitutor/animal{
	dir = 8
	},
/obj/machinery/light{
	dir = 4;
	status = 3
	},
/obj/effect/spider/stickyweb,
/turf/simulated/shuttle/floor,
/area/space_structures/collector_ship)
"be" = (
/obj/structure/table/reinforced,
/obj/item/weapon/virusdish/random,
/obj/effect/spider/stickyweb,
/turf/simulated/shuttle/floor,
/area/space_structures/collector_ship)
"bf" = (
/obj/item/weapon/camera_assembly,
/obj/item/weapon/table_parts/reinforced,
/turf/simulated/shuttle/floor,
/area/space_structures/collector_ship)
"bg" = (
/obj/structure/rack,
/obj/item/clothing/accessory/storage/webbing,
/obj/effect/spider/stickyweb,
/turf/simulated/shuttle/floor,
/area/space_structures/collector_ship)
"bh" = (
/obj/structure/computerframe,
/obj/item/weapon/shard,
/turf/simulated/shuttle/floor,
/area/space_structures/collector_ship)
"bi" = (
/obj/effect/spider/stickyweb,
/mob/living/simple_animal/hostile/giant_spider,
/turf/simulated/shuttle/floor,
/area/space_structures/collector_ship)
"bj" = (
/obj/structure/filingcabinet/filingcabinet,
/obj/effect/spider/stickyweb,
/turf/simulated/shuttle/floor,
/area/space_structures/collector_ship)
"bk" = (
/turf/space,
/turf/simulated/shuttle/wall{
	icon_state = "swall_s5"
	},
/area/space_structures/collector_ship)
"bl" = (
/obj/structure/window/phoronreinforced{
	dir = 6
	},
/obj/structure/grille,
/obj/effect/spider/stickyweb{
	opacity = 1
	},
/turf/simulated/shuttle/floor{
	icon_state = "vwall12"
	},
/area/space_structures/collector_ship)

(1,1,1) = {"
aa
aa
aa
aa
ac
an
ay
an
aO
aU
aa
aa
aa
"}
(2,1,1) = {"
aa
ac
aj
at
ad
az
aE
aH
aP
aV
an
an
bk
"}
(3,1,1) = {"
aa
ad
ak
as
ad
aA
aF
aI
ad
aW
bb
be
ad
"}
(4,1,1) = {"
aa
ae
aj
at
ae
aj
at
an
aQ
aX
as
bf
ad
"}
(5,1,1) = {"
ab
af
al
as
as
aB
as
aJ
at
aY
aX
bg
bl
"}
(6,1,1) = {"
ab
ag
am
as
as
as
as
aK
aR
as
as
bh
bl
"}
(7,1,1) = {"
aa
ah
an
an
an
aj
at
an
aS
as
bc
bi
bl
"}
(8,1,1) = {"
aa
ad
ao
au
aw
aC
as
aL
ad
aZ
bd
bj
ad
"}
(9,1,1) = {"
aa
ad
ap
as
as
as
as
aM
aP
aO
an
an
aT
"}
(10,1,1) = {"
aa
ad
aq
av
ax
aD
aG
aN
aP
aT
aa
aa
aa
"}
(11,1,1) = {"
aa
ai
an
an
ay
ay
an
an
aT
aa
aa
aa
aa
"}
