//MAP CONVERTED BY dmm2tgm.py THIS HEADER COMMENT PREVENTS RECONVERSION, DO NOT REMOVE
"a" = (
/turf/environment/space,
/area/space)
"b" = (
/turf/environment/space,
/turf/simulated/shuttle/wall{
	icon_state = "swall5"
	},
/area/space_structures/delivery_shuttle)
"c" = (
/obj/structure/shuttle/window{
	dir = 4;
	icon_state = "2"
	},
/turf/simulated/shuttle/floor{
	icon_state = "floor3"
	},
/area/space_structures/delivery_shuttle)
"d" = (
/turf/environment/space,
/turf/simulated/shuttle/wall{
	dir = 8;
	icon_state = "swall5"
	},
/area/space_structures/delivery_shuttle)
"e" = (
/turf/simulated/shuttle/wall{
	dir = 1;
	icon_state = "swall1"
	},
/area/space_structures/delivery_shuttle)
"f" = (
/obj/structure/computerframe{
	anchored = 1;
	dir = 2
	},
/obj/item/weapon/shard,
/obj/machinery/door_control{
	id = "pizza";
	name = "Cargo Compartment Control";
	pixel_x = 25
	},
/obj/machinery/light/small{
	dir = 8
	},
/turf/simulated/shuttle/floor{
	icon_state = "floor3"
	},
/area/space_structures/delivery_shuttle)
"g" = (
/obj/machinery/door/unpowered/shuttle,
/turf/simulated/shuttle/floor{
	icon_state = "floor3"
	},
/area/space_structures/delivery_shuttle)
"h" = (
/turf/simulated/shuttle/wall{
	icon_state = "swall2"
	},
/area/space_structures/delivery_shuttle)
"i" = (
/obj/structure/stool/bed/chair/schair/wagon{
	dir = 1
	},
/turf/simulated/shuttle/floor{
	icon_state = "floor3"
	},
/area/space_structures/delivery_shuttle)
"j" = (
/obj/structure/shuttle/window{
	icon_state = "2"
	},
/turf/simulated/shuttle/floor{
	icon_state = "floor3"
	},
/area/space_structures/delivery_shuttle)
"k" = (
/turf/simulated/shuttle/wall{
	dir = 4;
	icon_state = "swall2"
	},
/area/space_structures/delivery_shuttle)
"l" = (
/turf/simulated/shuttle/wall{
	dir = 4;
	icon_state = "swall3"
	},
/area/space_structures/delivery_shuttle)
"m" = (
/obj/structure/closet/crate/freezer/rations,
/obj/random/foods/food_without_garbage,
/obj/random/foods/food_without_garbage,
/obj/random/foods/donuts,
/obj/random/foods/donuts,
/obj/item/weapon/reagent_containers/food/snacks/grown/killertomato,
/obj/item/weapon/reagent_containers/food/snacks/candy/yumbaton,
/obj/random/foods/drink_bottle,
/obj/random/foods/food_without_garbage,
/turf/simulated/shuttle/floor{
	icon_state = "floor3"
	},
/area/space_structures/delivery_shuttle)
"n" = (
/obj/machinery/light/small{
	dir = 8
	},
/turf/simulated/shuttle/floor{
	icon_state = "floor3"
	},
/area/space_structures/delivery_shuttle)
"o" = (
/turf/simulated/shuttle/floor{
	icon_state = "floor3"
	},
/area/space_structures/delivery_shuttle)
"p" = (
/obj/machinery/light/small{
	dir = 4
	},
/turf/simulated/shuttle/floor{
	icon_state = "floor3"
	},
/area/space_structures/delivery_shuttle)
"q" = (
/obj/structure/closet/crate/freezer,
/obj/item/pizzabox/margherita,
/obj/item/pizzabox/meat,
/obj/random/foods/food_without_garbage,
/obj/random/foods/food_without_garbage,
/obj/random/foods/donuts,
/obj/item/weapon/reagent_containers/food/snacks/dionaroast,
/obj/item/weapon/reagent_containers/food/drinks/bottle/goldschlager,
/obj/random/foods/food_without_garbage,
/turf/simulated/shuttle/floor{
	icon_state = "floor3"
	},
/area/space_structures/delivery_shuttle)
"r" = (
/obj/machinery/door/poddoor/shutters{
	id = "pizza";
	name = "Cargo Compartment Shutters"
	},
/turf/simulated/shuttle/floor{
	icon_state = "floor3"
	},
/area/space_structures/delivery_shuttle)
"s" = (
/obj/structure/shuttle/engine/propulsion,
/turf/environment/space,
/area/space_structures/delivery_shuttle)
"t" = (
/obj/structure/closet/crate/freezer,
/obj/item/weapon/reagent_containers/food/snacks/sushi,
/obj/item/weapon/reagent_containers/food/snacks/sushi,
/obj/item/weapon/reagent_containers/food/snacks/sashimi,
/obj/item/weapon/reagent_containers/food/snacks/sashimi,
/obj/random/foods/food_without_garbage,
/obj/random/foods/food_without_garbage,
/obj/item/weapon/reagent_containers/food/snacks/clownburger,
/obj/random/foods,
/obj/random/foods/drink_bottle,
/obj/random/foods/food_without_garbage,
/turf/simulated/shuttle/floor{
	icon_state = "floor3"
	},
/area/space_structures/delivery_shuttle)
"u" = (
/obj/structure/shuttle/engine/heater{
	icon_state = "heater1"
	},
/turf/simulated/shuttle/wall{
	dir = 1;
	icon_state = "swall1"
	},
/area/space_structures/delivery_shuttle)

(1,1,1) = {"
a
a
a
b
h
h
u
s
"}
(2,1,1) = {"
b
e
g
k
m
n
r
a
"}
(3,1,1) = {"
c
f
i
c
q
o
r
a
"}
(4,1,1) = {"
d
h
j
l
t
p
r
a
"}
(5,1,1) = {"
a
a
a
d
h
h
u
s
"}
