//MAP CONVERTED BY dmm2tgm.py THIS HEADER COMMENT PREVENTS RECONVERSION, DO NOT REMOVE
"a" = (
/turf/space,
/area/space)
"b" = (
/turf/simulated/mineral/random/caves,
/area/space_structures/lost_asteroid)
"c" = (
/turf/simulated/mineral/random/labormineral,
/area/space_structures/lost_asteroid)
"d" = (
/obj/machinery/telecomms/relay,
/turf/simulated/floor/pod,
/area/space_structures/lost_asteroid)
"e" = (
/turf/simulated/mineral/random/high_chance,
/area/space_structures/lost_asteroid)
"f" = (
/obj/structure/inflatable/survival,
/turf/simulated/floor/pod,
/area/space_structures/lost_asteroid)
"g" = (
/obj/structure/inflatable/survival,
/obj/structure/sign/mining/archaeology/survival{
	dir = 1
	},
/turf/simulated/floor/pod,
/area/space_structures/lost_asteroid)
"h" = (
/turf/simulated/wall,
/area/space_structures/lost_asteroid)
"i" = (
/obj/machinery/mineral/unloading_machine{
	icon_state = "unloader-corner"
	},
/turf/simulated/floor/plating/airless{
	icon_state = "asteroidplating"
	},
/area/space_structures/lost_asteroid)
"j" = (
/obj/machinery/conveyor{
	dir = 4;
	id = "mining_external"
	},
/obj/machinery/mineral/input,
/turf/simulated/floor/plating/airless{
	icon_state = "asteroidplating"
	},
/area/space_structures/lost_asteroid)
"k" = (
/turf/simulated/floor/plating/airless/asteroid,
/area/space_structures/lost_asteroid)
"l" = (
/obj/structure/window/reinforced/tinted,
/obj/structure/window/reinforced/tinted{
	dir = 4
	},
/obj/structure/window/reinforced/tinted{
	dir = 1
	},
/obj/structure/window/reinforced/tinted{
	dir = 8
	},
/obj/structure/grille,
/turf/simulated/floor/plating/airless{
	icon_state = "asteroidplating"
	},
/area/space_structures/lost_asteroid)
"m" = (
/obj/structure/fans,
/turf/simulated/floor/pod,
/area/space_structures/lost_asteroid)
"n" = (
/obj/machinery/conveyor{
	id = "mining_internal"
	},
/obj/machinery/mineral/output,
/obj/machinery/light{
	dir = 8
	},
/turf/simulated/floor/plating/airless{
	icon_state = "asteroidplating"
	},
/area/space_structures/lost_asteroid)
"o" = (
/turf/simulated/floor/pod,
/area/space_structures/lost_asteroid)
"p" = (
/obj/structure/table,
/obj/item/device/flashlight/lamp,
/turf/simulated/floor/pod,
/area/space_structures/lost_asteroid)
"q" = (
/obj/structure/table,
/obj/item/weapon/paper_bin,
/obj/item/weapon/pen,
/turf/simulated/floor/pod,
/area/space_structures/lost_asteroid)
"r" = (
/obj/machinery/conveyor{
	id = "mining_internal"
	},
/obj/machinery/mineral/output,
/turf/simulated/floor/plating/airless{
	icon_state = "asteroidplating"
	},
/area/space_structures/lost_asteroid)
"s" = (
/turf/simulated/floor/plating/airless{
	icon_state = "asteroidplating"
	},
/area/space_structures/lost_asteroid)
"t" = (
/obj/structure/window/reinforced{
	dir = 8
	},
/obj/structure/ore_box,
/turf/simulated/floor/plating/airless/asteroid,
/area/space_structures/lost_asteroid)
"u" = (
/obj/machinery/power/port_gen/pacman,
/turf/simulated/floor/plating/airless/asteroid,
/area/space_structures/lost_asteroid)
"v" = (
/obj/structure/window/reinforced{
	dir = 4
	},
/obj/structure/closet/crate,
/obj/item/weapon/pickaxe,
/obj/item/weapon/storage/bag/ore,
/turf/simulated/floor/plating/airless/asteroid,
/area/space_structures/lost_asteroid)
"w" = (
/obj/structure/survivor_cryopod/geologist,
/turf/simulated/floor/pod,
/area/space_structures/lost_asteroid)
"x" = (
/obj/structure/stool/bed/pod,
/obj/item/weapon/bedsheet,
/turf/simulated/floor/pod,
/area/space_structures/lost_asteroid)
"y" = (
/obj/structure/inflatable/door/survival_pod,
/turf/simulated/floor/pod,
/area/space_structures/lost_asteroid)
"z" = (
/mob/living/simple_animal/hostile/mining_drone,
/turf/simulated/floor/pod,
/area/space_structures/lost_asteroid)
"A" = (
/obj/structure/inflatable/door/survival_pod{
	density = 0;
	icon_state = "door_surv_open"
	},
/obj/item/weapon/wrench,
/turf/simulated/floor/pod,
/area/space_structures/lost_asteroid)
"B" = (
/obj/machinery/conveyor{
	id = "mining_internal"
	},
/obj/machinery/power/apc{
	dir = 8;
	name = "Worn-out APC";
	pixel_x = -24
	},
/turf/simulated/floor/plating/airless/asteroid,
/area/space_structures/lost_asteroid)
"C" = (
/obj/item/weapon/reagent_containers/glass/bucket,
/obj/item/weapon/shovel,
/turf/simulated/floor/plating/airless/asteroid,
/area/space_structures/lost_asteroid)
"D" = (
/obj/structure/pit,
/turf/simulated/floor/plating/airless/asteroid,
/area/space_structures/lost_asteroid)
"E" = (
/obj/structure/inflatable/survival,
/obj/structure/sign/mining/archaeology/survival{
	dir = 8
	},
/turf/simulated/floor/pod,
/area/space_structures/lost_asteroid)
"F" = (
/obj/structure/stool/bed/chair/comfy/beige{
	dir = 8
	},
/turf/simulated/floor/pod,
/area/space_structures/lost_asteroid)
"G" = (
/obj/structure/table,
/obj/item/rig_module/device/orescanner,
/obj/item/weapon/screwdriver,
/turf/simulated/floor/pod,
/area/space_structures/lost_asteroid)
"H" = (
/obj/structure/table,
/obj/item/weapon/storage/toolbox/mechanical,
/turf/simulated/floor/pod,
/area/space_structures/lost_asteroid)
"I" = (
/obj/machinery/mineral/input,
/obj/machinery/conveyor{
	id = "mining_internal"
	},
/obj/machinery/mineral/processing_unit_console{
	machinedir = 2;
	pixel_x = -32
	},
/turf/simulated/floor/plating/airless{
	icon_state = "asteroidplating"
	},
/area/space_structures/lost_asteroid)
"J" = (
/obj/structure/table,
/obj/item/weapon/wrench,
/obj/item/weapon/storage/firstaid/small_firstaid_kit/space,
/turf/simulated/floor/pod,
/area/space_structures/lost_asteroid)
"K" = (
/obj/structure/fans/tiny,
/obj/structure/inflatable/door/survival_pod,
/turf/simulated/floor/pod,
/area/space_structures/lost_asteroid)
"L" = (
/obj/structure/inflatable/survival,
/obj/structure/sign/mining/archaeology,
/turf/simulated/floor/pod,
/area/space_structures/lost_asteroid)
"M" = (
/obj/machinery/mineral/processing_unit,
/turf/simulated/floor/plating/airless{
	icon_state = "asteroidplating"
	},
/area/space_structures/lost_asteroid)
"N" = (
/obj/structure/inflatable/survival,
/obj/structure/sign/mining/archaeology/survival,
/turf/simulated/floor/pod,
/area/space_structures/lost_asteroid)

(1,1,1) = {"
a
a
a
a
a
a
a
a
a
a
a
a
a
a
a
a
a
a
a
a
a
b
b
b
b
b
b
a
a
a
a
a
a
a
a
a
a
a
a
a
a
a
a
"}
(2,1,1) = {"
a
a
a
a
a
a
a
a
a
a
a
a
a
a
a
a
b
b
b
b
b
b
b
b
b
b
b
b
b
b
b
a
a
a
a
a
a
a
a
a
a
a
a
"}
(3,1,1) = {"
a
a
a
a
a
a
a
a
a
a
a
a
a
a
a
b
b
b
b
b
b
c
c
c
c
c
c
c
b
b
b
b
b
b
b
a
a
a
a
a
a
a
a
"}
(4,1,1) = {"
a
a
a
a
a
a
a
a
a
a
a
a
b
b
b
b
c
c
c
c
c
c
c
c
c
c
c
c
c
c
c
c
c
c
b
b
a
a
a
a
a
a
a
"}
(5,1,1) = {"
a
a
a
a
a
a
a
a
a
a
a
a
b
b
b
b
c
c
c
c
c
c
c
b
b
b
b
b
e
c
c
c
c
c
c
b
b
a
a
a
a
a
a
"}
(6,1,1) = {"
a
a
a
a
a
a
a
a
a
a
a
a
b
b
c
c
c
c
c
b
b
b
b
b
b
b
b
b
b
b
c
c
c
c
c
c
b
a
a
a
a
a
a
"}
(7,1,1) = {"
a
a
a
a
a
a
a
a
b
b
b
b
b
b
c
c
b
b
b
b
b
b
b
b
b
b
b
b
b
b
b
c
c
c
c
c
b
a
a
a
a
a
a
"}
(8,1,1) = {"
a
a
a
a
a
a
a
b
b
b
b
b
b
c
c
c
b
b
b
b
b
e
b
b
b
b
b
b
b
b
b
c
c
c
c
b
b
k
a
a
a
a
a
"}
(9,1,1) = {"
a
a
a
a
a
a
b
b
b
c
c
c
c
c
c
b
e
b
b
b
b
b
b
b
b
b
b
b
b
b
c
c
b
b
b
b
b
k
k
k
a
a
a
"}
(10,1,1) = {"
a
a
a
a
a
b
b
b
c
c
c
c
c
b
b
b
b
b
b
b
b
b
b
e
b
b
b
b
b
b
c
b
h
h
h
h
h
h
h
k
a
a
a
"}
(11,1,1) = {"
a
a
a
a
a
b
b
b
c
c
c
b
b
b
b
b
b
b
e
b
b
b
b
e
b
b
b
b
c
c
c
b
h
i
n
B
I
M
r
k
k
a
a
"}
(12,1,1) = {"
a
a
a
a
b
b
b
c
c
c
c
b
b
b
b
b
b
b
e
e
e
b
b
b
b
b
b
b
c
c
b
b
h
j
s
k
k
k
s
s
k
a
a
"}
(13,1,1) = {"
a
a
a
a
b
b
c
c
c
c
c
b
b
b
b
b
b
e
b
b
b
b
b
e
b
b
b
b
c
c
b
b
b
k
k
s
s
s
e
s
k
k
a
"}
(14,1,1) = {"
a
a
a
b
b
b
c
c
c
c
b
b
b
b
b
e
b
b
e
b
b
b
b
e
b
b
b
b
c
c
b
b
b
k
k
k
k
e
e
k
e
k
k
"}
(15,1,1) = {"
a
a
b
b
b
c
c
c
b
b
b
b
b
b
e
b
b
b
b
b
e
b
b
b
b
b
b
b
c
c
b
b
b
h
t
k
k
e
e
s
e
e
k
"}
(16,1,1) = {"
a
b
b
b
b
c
c
c
b
b
b
e
b
b
b
b
b
e
b
b
b
b
e
b
b
b
b
b
c
c
b
b
b
l
u
k
e
e
e
s
e
k
k
"}
(17,1,1) = {"
a
b
b
c
c
c
b
b
b
b
b
b
b
b
b
b
b
b
b
b
b
b
b
b
e
b
b
b
c
c
b
b
b
h
v
k
k
e
e
k
e
k
k
"}
(18,1,1) = {"
a
b
b
c
c
c
b
b
b
b
b
b
b
b
b
b
b
b
b
b
b
b
b
b
b
b
b
b
b
c
b
b
b
b
b
C
k
k
k
s
k
k
k
"}
(19,1,1) = {"
a
b
b
c
c
b
b
b
b
b
b
b
b
b
e
b
b
e
b
b
b
e
e
b
b
b
b
b
b
c
b
b
b
b
b
D
s
k
s
k
k
k
a
"}
(20,1,1) = {"
a
b
b
c
c
c
b
b
b
b
b
e
b
e
e
b
b
b
b
b
b
b
b
b
b
e
b
b
b
c
b
b
f
f
E
f
f
k
k
s
k
k
a
"}
(21,1,1) = {"
a
b
b
c
c
b
b
e
b
b
b
b
b
b
b
b
b
b
b
b
b
b
b
b
b
e
b
b
b
c
b
b
f
m
x
J
L
k
s
s
k
k
a
"}
(22,1,1) = {"
a
b
b
c
c
b
b
b
b
e
b
b
b
b
b
b
b
b
b
e
b
b
b
b
b
b
b
b
b
c
b
b
g
n
o
o
K
s
k
k
k
k
a
"}
(23,1,1) = {"
a
b
b
c
c
b
b
b
b
b
b
b
b
e
b
b
b
b
b
b
b
b
b
b
b
b
b
b
b
c
b
b
f
w
o
F
N
k
k
k
k
a
a
"}
(24,1,1) = {"
b
b
b
c
c
b
b
b
b
b
b
b
b
e
b
b
b
b
b
b
b
b
b
e
b
b
b
b
b
c
b
b
f
f
y
f
f
k
k
k
k
a
a
"}
(25,1,1) = {"
b
b
c
c
c
b
b
b
b
b
b
b
b
b
b
b
b
e
b
b
b
e
b
b
b
b
b
b
b
c
b
b
f
p
o
G
f
k
k
b
k
a
a
"}
(26,1,1) = {"
b
b
c
c
c
c
c
b
b
b
b
b
b
b
b
b
b
b
b
b
b
b
b
b
b
b
e
b
b
c
b
b
f
q
z
H
f
k
b
b
k
a
a
"}
(27,1,1) = {"
b
b
c
c
c
c
c
b
b
b
b
b
b
b
b
b
b
e
b
b
b
b
b
e
b
b
b
b
b
c
b
b
f
f
f
f
f
k
b
b
k
a
a
"}
(28,1,1) = {"
b
b
c
c
c
c
c
b
b
b
b
b
b
b
b
b
b
b
b
b
b
b
b
b
b
b
b
b
b
c
c
b
b
f
d
A
k
k
b
b
a
a
a
"}
(29,1,1) = {"
b
b
b
b
c
c
c
c
b
b
b
b
b
b
e
e
b
b
b
b
b
e
b
b
b
b
c
c
c
c
c
c
b
f
f
f
b
b
b
a
a
a
a
"}
(30,1,1) = {"
a
b
b
b
c
c
c
c
c
c
b
b
b
b
b
b
b
b
e
b
b
b
b
b
b
b
c
c
c
c
c
c
c
b
b
b
b
b
a
a
a
a
a
"}
(31,1,1) = {"
a
b
b
b
c
c
c
c
c
c
b
b
b
b
b
b
b
b
b
b
b
b
b
b
b
b
c
c
c
c
c
c
c
c
b
b
a
a
a
a
a
a
a
"}
(32,1,1) = {"
a
a
b
b
b
c
c
c
c
c
b
b
b
b
b
b
b
b
b
b
b
b
b
b
b
c
c
c
c
c
c
c
c
b
b
b
a
a
a
a
a
a
a
"}
(33,1,1) = {"
a
a
a
b
b
c
c
c
c
c
c
c
c
c
c
b
b
b
b
b
b
c
c
c
c
c
c
c
c
c
c
c
c
b
b
a
a
a
a
a
a
a
a
"}
(34,1,1) = {"
a
a
a
b
b
b
c
c
c
c
c
c
c
c
c
c
c
c
c
c
c
c
c
c
c
c
c
c
c
c
c
c
b
b
b
a
a
a
a
a
a
a
a
"}
(35,1,1) = {"
a
a
a
a
b
b
b
b
c
c
c
c
c
c
c
c
c
c
c
c
c
c
c
c
c
c
c
c
c
c
c
c
b
b
a
a
a
a
a
a
a
a
a
"}
(36,1,1) = {"
a
a
a
a
a
b
b
b
b
c
c
c
c
c
c
c
c
c
c
c
c
c
c
c
c
c
c
c
c
c
c
b
b
b
a
a
a
a
a
a
a
a
a
"}
(37,1,1) = {"
a
a
a
a
a
a
b
b
b
c
c
c
c
c
c
c
c
c
c
c
c
c
c
c
c
c
c
c
c
c
b
b
b
a
a
a
a
a
a
a
a
a
a
"}
(38,1,1) = {"
a
a
a
a
a
a
a
b
b
b
c
c
c
c
c
c
c
c
c
c
c
c
c
c
c
c
c
b
b
b
b
b
a
a
a
a
a
a
a
a
a
a
a
"}
(39,1,1) = {"
a
a
a
a
a
a
a
a
b
b
b
c
c
c
c
c
c
c
c
c
c
c
c
c
c
b
b
b
b
b
b
a
a
a
a
a
a
a
a
a
a
a
a
"}
(40,1,1) = {"
a
a
a
a
a
a
a
a
a
b
b
b
b
b
b
b
c
c
c
c
c
b
b
b
b
b
b
b
b
a
a
a
a
a
a
a
a
a
a
a
a
a
a
"}
(41,1,1) = {"
a
a
a
a
a
a
a
a
a
a
b
b
b
b
b
b
c
c
c
b
b
b
b
b
b
b
b
a
a
a
a
a
a
a
a
a
a
a
a
a
a
a
a
"}
(42,1,1) = {"
a
a
a
a
a
a
a
a
a
a
a
a
b
b
b
b
b
b
b
b
b
b
a
a
a
a
a
a
a
a
a
a
a
a
a
a
a
a
a
a
a
a
a
"}
(43,1,1) = {"
a
a
a
a
a
a
a
a
a
a
a
a
a
a
b
b
b
b
b
b
b
a
a
a
a
a
a
a
a
a
a
a
a
a
a
a
a
a
a
a
a
a
a
"}
(44,1,1) = {"
a
a
a
a
a
a
a
a
a
a
a
a
a
a
a
a
b
b
b
b
a
a
a
a
a
a
a
a
a
a
a
a
a
a
a
a
a
a
a
a
a
a
a
"}
