//MAP CONVERTED BY dmm2tgm.py THIS HEADER COMMENT PREVENTS RECONVERSION, DO NOT REMOVE
"a" = (
/turf/space,
/area/space)
"b" = (
/turf/space,
/turf/simulated/shuttle/wall{
	dir = 8;
	icon_state = "diagonalWall3"
	},
/area/space_structures/mercenary_pod)
"c" = (
/turf/space,
/turf/simulated/shuttle/wall{
	dir = 1;
	icon_state = "diagonalWall3"
	},
/area/space_structures/mercenary_pod)
"d" = (
/obj/structure/shuttle/engine/propulsion{
	dir = 8
	},
/turf/simulated/floor/plating/airless,
/area/space_structures/mercenary_pod)
"e" = (
/turf/simulated/shuttle/wall{
	icon_state = "wall3"
	},
/area/space_structures/mercenary_pod)
"f" = (
/obj/machinery/porta_turret/stationary{
	shot_synth = 1
	},
/turf/simulated/floor/plating/airless,
/area/space_structures/mercenary_pod)
"g" = (
/turf/space,
/turf/simulated/shuttle/wall{
	icon_state = "diagonalWall3"
	},
/area/space_structures/mercenary_pod)
"h" = (
/obj/structure/rack,
/obj/item/clothing/suit/space/syndicate/elite,
/obj/item/clothing/head/helmet/space/syndicate/elite,
/turf/simulated/floor/plating,
/area/space_structures/mercenary_pod)
"i" = (
/obj/item/weapon/gun/projectile/automatic/luger,
/turf/simulated/floor/plating,
/area/space_structures/mercenary_pod)
"j" = (
/obj/machinery/door/airlock/centcom,
/obj/machinery/door/poddoor{
	id = "mercstorage"
	},
/turf/space,
/area/space_structures/mercenary_pod)
"k" = (
/obj/effect/decal/cleanable/blood,
/turf/simulated/shuttle/floor{
	icon_state = "floor7"
	},
/area/space_structures/mercenary_pod)
"l" = (
/turf/simulated/shuttle/floor{
	icon_state = "floor7"
	},
/area/space_structures/mercenary_pod)
"m" = (
/obj/machinery/light_construct/small{
	dir = 1
	},
/obj/effect/decal/cleanable/ash,
/turf/simulated/shuttle/floor{
	icon_state = "floor7"
	},
/area/space_structures/mercenary_pod)
"n" = (
/obj/structure/alien/weeds,
/obj/structure/stool/bed/nest,
/turf/simulated/shuttle/floor{
	icon_state = "floor7"
	},
/area/space_structures/mercenary_pod)
"o" = (
/obj/structure/rack,
/obj/item/clothing/mask/gas/swat,
/obj/item/clothing/mask/gas/swat,
/turf/simulated/shuttle/floor{
	icon_state = "floor7"
	},
/area/space_structures/mercenary_pod)
"p" = (
/obj/structure/survivor_cryopod/syndicate/opened{
	dir = 1
	},
/turf/simulated/shuttle/floor{
	icon_state = "floor7"
	},
/area/space_structures/mercenary_pod)
"q" = (
/obj/structure/survivor_cryopod/syndicate/mercenary,
/turf/simulated/shuttle/floor{
	icon_state = "floor7"
	},
/area/space_structures/mercenary_pod)
"r" = (
/obj/structure/alien/weeds,
/mob/living/simple_animal/hostile/alien/queen{
	destroy_surroundings = 0
	},
/turf/simulated/shuttle/floor{
	icon_state = "floor7"
	},
/area/space_structures/mercenary_pod)
"s" = (
/obj/machinery/light_construct/small{
	dir = 1
	},
/obj/structure/alien/weeds,
/turf/simulated/shuttle/floor{
	icon_state = "floor7"
	},
/area/space_structures/mercenary_pod)
"t" = (
/obj/structure/table/reinforced,
/obj/machinery/turretid/lethal,
/obj/structure/alien/weeds,
/turf/simulated/shuttle/floor{
	icon_state = "floor7"
	},
/area/space_structures/mercenary_pod)
"u" = (
/obj/structure/grille,
/obj/structure/window/reinforced{
	dir = 5;
	health = 1e+007
	},
/obj/machinery/door/poddoor{
	id = "mercpod"
	},
/turf/simulated/floor/plating,
/area/space_structures/mercenary_pod)
"v" = (
/obj/machinery/door/airlock/hatch,
/turf/simulated/shuttle/floor{
	icon_state = "floor7"
	},
/area/space_structures/mercenary_pod)
"w" = (
/obj/effect/mine/stun,
/obj/effect/decal/cleanable/blood/gibs/limb,
/turf/simulated/shuttle/floor{
	icon_state = "floor7"
	},
/area/space_structures/mercenary_pod)
"x" = (
/obj/effect/mine/stun,
/turf/simulated/shuttle/floor{
	icon_state = "floor7"
	},
/area/space_structures/mercenary_pod)
"y" = (
/obj/machinery/door/airlock/centcom,
/obj/structure/barricade/wooden,
/turf/simulated/shuttle/floor{
	icon_state = "floor7"
	},
/area/space_structures/mercenary_pod)
"z" = (
/obj/structure/alien/weeds,
/turf/simulated/shuttle/floor{
	icon_state = "floor7"
	},
/area/space_structures/mercenary_pod)
"A" = (
/obj/structure/table/reinforced,
/obj/structure/alien/weeds,
/obj/item/clothing/head/beret/fluff/marine_beret,
/turf/simulated/shuttle/floor{
	icon_state = "floor7"
	},
/area/space_structures/mercenary_pod)
"B" = (
/obj/structure/survivor_cryopod/syndicate/opened,
/turf/simulated/shuttle/floor{
	icon_state = "floor7"
	},
/area/space_structures/mercenary_pod)
"C" = (
/obj/effect/decal/cleanable/blood/xeno,
/turf/simulated/shuttle/floor{
	icon_state = "floor7"
	},
/area/space_structures/mercenary_pod)
"D" = (
/obj/structure/alien/weeds,
/obj/structure/alien/air_plant,
/turf/simulated/shuttle/floor{
	icon_state = "floor7"
	},
/area/space_structures/mercenary_pod)
"E" = (
/obj/machinery/light/small/emergency{
	status = 2
	},
/obj/structure/alien/weeds,
/turf/simulated/shuttle/floor{
	icon_state = "floor7"
	},
/area/space_structures/mercenary_pod)
"F" = (
/obj/structure/table/reinforced,
/obj/machinery/door_control{
	id = "mercpod";
	name = "Cockpit Shutters Control";
	pixel_x = -6;
	pixel_y = 5
	},
/obj/machinery/door_control{
	id = "mercstorage";
	name = "Storage Shutters Control";
	pixel_x = 6;
	pixel_y = 5
	},
/obj/structure/alien/weeds,
/turf/simulated/shuttle/floor{
	icon_state = "floor7"
	},
/area/space_structures/mercenary_pod)
"G" = (
/obj/machinery/power/port_gen/pacman/super,
/turf/simulated/floor/plating,
/area/space_structures/mercenary_pod)
"H" = (
/obj/machinery/light/small/emergency,
/turf/simulated/shuttle/floor{
	icon_state = "floor7"
	},
/area/space_structures/mercenary_pod)
"I" = (
/obj/structure/closet/walllocker{
	pixel_y = -32
	},
/obj/item/clothing/mask/facehugger,
/obj/item/ammo_box/c9mm,
/turf/simulated/shuttle/floor{
	icon_state = "floor7"
	},
/area/space_structures/mercenary_pod)
"J" = (
/obj/item/weapon/rack_parts,
/turf/simulated/shuttle/floor{
	icon_state = "floor7"
	},
/area/space_structures/mercenary_pod)
"K" = (
/turf/space,
/turf/simulated/shuttle/wall{
	dir = 4;
	icon_state = "diagonalWall3"
	},
/area/space_structures/mercenary_pod)
"L" = (
/obj/structure/closet/crate,
/obj/item/stack/sheet/mineral/uranium,
/obj/item/stack/sheet/mineral/uranium,
/obj/item/stack/sheet/mineral/uranium,
/turf/simulated/floor/plating,
/area/space_structures/mercenary_pod)
"M" = (
/obj/effect/decal/cleanable/molten_item,
/turf/simulated/shuttle/floor{
	icon_state = "floor7"
	},
/area/space_structures/mercenary_pod)
"N" = (
/obj/structure/sign/poster{
	pixel_y = -32
	},
/turf/simulated/shuttle/floor{
	icon_state = "floor7"
	},
/area/space_structures/mercenary_pod)

(1,1,1) = {"
b
d
g
a
a
a
a
a
b
d
g
"}
(2,1,1) = {"
c
e
e
e
e
v
e
e
e
e
K
"}
(3,1,1) = {"
a
c
h
i
e
l
e
G
L
K
a
"}
(4,1,1) = {"
a
a
e
j
e
v
e
j
e
a
a
"}
(5,1,1) = {"
a
a
e
k
l
w
l
l
e
a
a
"}
(6,1,1) = {"
a
a
e
l
p
e
B
l
e
a
a
"}
(7,1,1) = {"
a
a
e
l
l
e
C
l
e
a
a
"}
(8,1,1) = {"
a
b
e
m
p
e
q
H
e
g
a
"}
(9,1,1) = {"
a
f
e
n
l
e
l
I
e
f
a
"}
(10,1,1) = {"
a
c
e
l
p
e
B
N
e
K
a
"}
(11,1,1) = {"
a
a
e
o
k
x
M
J
e
a
a
"}
(12,1,1) = {"
a
a
c
e
e
y
e
e
K
a
a
"}
(13,1,1) = {"
a
a
a
e
n
z
D
e
a
a
a
"}
(14,1,1) = {"
a
a
a
e
s
r
E
e
a
a
a
"}
(15,1,1) = {"
a
a
a
e
t
A
F
e
a
a
a
"}
(16,1,1) = {"
a
a
a
c
u
u
u
K
a
a
a
"}
