//MAP CONVERTED BY dmm2tgm.py THIS HEADER COMMENT PREVENTS RECONVERSION, DO NOT REMOVE
"a" = (
/turf/space,
/area/space)
"b" = (
/turf/simulated/shuttle/wall{
	icon_state = "wall3"
	},
/area/space_structures/syndicate_fighter)
"c" = (
/obj/structure/cable{
	d1 = 2;
	d2 = 4;
	icon_state = "2-4"
	},
/obj/structure/girder,
/turf/simulated/floor/plating,
/area/space_structures/syndicate_fighter)
"d" = (
/obj/item/stack/sheet/metal,
/obj/machinery/porta_turret_construct,
/turf/simulated/floor/plating,
/area/space_structures/syndicate_fighter)
"e" = (
/obj/structure/shuttle/engine/propulsion{
	dir = 8;
	icon_state = "burst_l"
	},
/turf/simulated/shuttle/wall{
	icon_state = "wall3"
	},
/area/space_structures/syndicate_fighter)
"f" = (
/obj/structure/computerframe,
/obj/machinery/door_control{
	id = "syndishiv";
	name = "Airlock Bolt Control";
	pixel_x = -25;
	pixel_y = 0
	},
/obj/item/weapon/shard{
	icon_state = "small"
	},
/obj/item/stack/cable_coil/random{
	amount = 2
	},
/turf/simulated/shuttle/floor4{
	name = "red floor";
	nitrogen = 103.984;
	oxygen = 0
	},
/area/space_structures/syndicate_fighter)
"g" = (
/obj/machinery/porta_turret/stationary{
	check_n_synth = 1;
	shot_synth = 1
	},
/turf/simulated/shuttle/wall{
	icon_state = "wall3"
	},
/area/space_structures/syndicate_fighter)
"h" = (
/obj/machinery/door/airlock/hatch{
	id_tag = "syndishiv";
	locked = 1
	},
/obj/structure/fans/tiny,
/turf/simulated/shuttle/floor4{
	name = "red floor";
	nitrogen = 103.984;
	oxygen = 0
	},
/area/space_structures/syndicate_fighter)
"i" = (
/obj/structure/stool/bed/chair/schair/wagon{
	dir = 4
	},
/turf/simulated/shuttle/floor4{
	name = "red floor";
	nitrogen = 103.984;
	oxygen = 0
	},
/area/space_structures/syndicate_fighter)
"j" = (
/obj/machinery/light/small{
	dir = 4
	},
/obj/machinery/computer/security/nuclear/shiv{
	dir = 8
	},
/turf/simulated/shuttle/floor4{
	name = "red floor";
	nitrogen = 103.984;
	oxygen = 0
	},
/area/space_structures/syndicate_fighter)
"k" = (
/obj/machinery/camera/emp_proof{
	c_tag = "Front";
	dir = 4;
	name = "military-grade camera";
	network = list("shiv");
	pixel_y = -10
	},
/turf/space,
/area/space_structures/syndicate_fighter)
"l" = (
/obj/structure/rack,
/obj/structure/closet/walllocker{
	pixel_x = -32
	},
/obj/item/weapon/tank/emergency_oxygen/engi,
/obj/item/clothing/mask/gas/syndicate,
/obj/item/clothing/head/helmet/space/syndicate/infiltrator,
/turf/simulated/shuttle/floor4{
	name = "red floor";
	nitrogen = 103.984;
	oxygen = 0
	},
/area/space_structures/syndicate_fighter)

(1,1,1) = {"
a
a
e
b
h
b
e
a
a
"}
(2,1,1) = {"
a
e
b
f
i
l
b
e
a
"}
(3,1,1) = {"
b
b
b
b
j
b
b
b
b
"}
(4,1,1) = {"
c
b
a
g
b
g
a
b
b
"}
(5,1,1) = {"
d
a
a
a
k
a
a
a
g
"}
