//MAP CONVERTED BY dmm2tgm.py THIS HEADER COMMENT PREVENTS RECONVERSION, DO NOT REMOVE
"a" = (
/turf/space,
/area/space)
"b" = (
/obj/effect/decal/cleanable/toilet_paint,
/turf/simulated/wall,
/area/space)
"c" = (
/obj/structure/window/reinforced{
	dir = 4
	},
/obj/machinery/atmospherics/components/unary/thermomachine/heater,
/turf/simulated/floor/plating,
/area/space)
"d" = (
/obj/structure/toilet{
	pixel_y = 8
	},
/obj/effect/decal/cleanable/cobweb,
/turf/simulated/floor/plating,
/area/space)
"e" = (
/obj/structure/window/reinforced{
	dir = 8
	},
/obj/machinery/atmospherics/components/unary/tank/air,
/turf/simulated/floor/plating,
/area/space)
"f" = (
/obj/structure/window/reinforced{
	dir = 4
	},
/obj/machinery/atmospherics/pipe/simple/visible,
/turf/simulated/floor/plating,
/area/space)
"g" = (
/obj/machinery/door/window/southright,
/turf/simulated/floor/plating,
/area/space)
"h" = (
/obj/structure/window/reinforced{
	dir = 8
	},
/obj/machinery/meter,
/obj/machinery/atmospherics/pipe/simple/visible,
/turf/simulated/floor/plating,
/area/space)
"i" = (
/obj/machinery/atmospherics/pipe/simple/visible{
	dir = 5
	},
/turf/simulated/floor/plating,
/area/space)
"j" = (
/obj/machinery/atmospherics/components/binary/valve{
	dir = 4
	},
/turf/simulated/floor/plating,
/area/space)
"k" = (
/obj/structure/stool,
/obj/effect/decal/remains/human,
/obj/machinery/atmospherics/pipe/simple/visible{
	dir = 9
	},
/turf/simulated/floor/plating,
/area/space)
"l" = (
/turf/simulated/floor/plating,
/area/space)

(1,1,1) = {"
a
c
f
i
a
"}
(2,1,1) = {"
b
d
g
j
l
"}
(3,1,1) = {"
a
e
h
k
a
"}
