//MAP CONVERTED BY dmm2tgm.py THIS HEADER COMMENT PREVENTS RECONVERSION, DO NOT REMOVE
"a" = (
/turf/simulated/shuttle/floor/evac/place2,
/area/custom/arena)
"c" = (
/obj/effect/landmark/instagib_arena/sinner,
/turf/simulated/shuttle/floor/evac/inv,
/area/custom/arena)
"f" = (
/obj/structure/window/fulltile/reinforced/indestructible{
	icon_state = "gr_window_reinforced"
	},
/turf/environment/space,
/area/custom/arena)
"g" = (
/turf/simulated/shuttle/floor/evac,
/area/custom/arena)
"h" = (
/turf/simulated/shuttle/floor/evac/eng2,
/area/custom/arena)
"i" = (
/obj/effect/landmark/instagib_arena/sinner,
/turf/simulated/shuttle/floor/evac/eng2,
/area/custom/arena)
"n" = (
/obj/structure/window/fulltile/reinforced/indestructible{
	icon_state = "gr_window_reinforced"
	},
/turf/simulated/shuttle/floor/evac,
/area/custom/arena)
"s" = (
/turf/simulated/shuttle/floor/evac/place,
/area/custom/arena)
"z" = (
/obj/structure/static_portal{
	color = "#ff4100";
	id = 1
	},
/turf/simulated/shuttle/floor/evac/eng1,
/area/custom/arena)
"B" = (
/turf/unsimulated/wall/like_a_normal/green,
/area/custom/arena)
"F" = (
/obj/structure/static_portal{
	color = "#ff4100";
	id = 1
	},
/turf/simulated/shuttle/floor/evac/place2,
/area/custom/arena)
"G" = (
/obj/effect/landmark/instagib_arena/sinner,
/turf/simulated/shuttle/floor/evac,
/area/custom/arena)
"J" = (
/obj/structure/static_portal{
	color = "#4572e3";
	id = 2
	},
/turf/simulated/shuttle/floor/evac/place2,
/area/custom/arena)
"K" = (
/turf/environment/space,
/area/space)
"M" = (
/obj/effect/landmark/instagib_arena/sinner,
/turf/simulated/shuttle/floor/evac/medbay,
/area/custom/arena)
"N" = (
/turf/unsimulated/wall/like_a_normal,
/area/custom/arena)
"O" = (
/turf/simulated/shuttle/floor/evac/medbay,
/area/custom/arena)
"S" = (
/obj/structure/static_portal{
	color = "#4572e3";
	id = 2
	},
/turf/simulated/shuttle/floor/evac/eng1,
/area/custom/arena)
"T" = (
/obj/structure/static_portal{
	color = "#8fd032";
	id = 3
	},
/turf/simulated/shuttle/floor/evac/place2,
/area/custom/arena)
"W" = (
/turf/simulated/shuttle/floor/evac/eng1,
/area/custom/arena)
"X" = (
/obj/structure/static_portal{
	color = "#8fd032";
	id = 3
	},
/turf/simulated/shuttle/floor/evac/eng1,
/area/custom/arena)

(1,1,1) = {"
K
K
K
K
K
K
K
K
K
K
K
K
K
K
K
K
K
K
K
K
K
K
K
K
K
K
K
K
K
K
K
K
K
K
K
K
K
K
K
K
K
K
K
K
K
"}
(2,1,1) = {"
K
K
K
K
K
K
K
K
K
K
K
K
K
K
K
K
K
K
K
K
K
K
K
K
K
K
K
K
K
K
K
K
K
K
B
B
B
B
B
K
K
K
K
K
K
"}
(3,1,1) = {"
K
K
K
K
K
K
K
K
K
K
K
K
K
K
K
K
K
K
K
K
K
K
K
K
K
K
K
K
K
K
K
K
K
K
B
W
S
W
B
K
K
K
K
K
K
"}
(4,1,1) = {"
K
K
K
K
K
K
K
K
K
K
K
K
K
K
K
K
K
K
K
K
K
K
K
K
K
K
K
K
K
K
K
K
K
K
B
W
h
W
B
K
K
K
K
K
K
"}
(5,1,1) = {"
K
K
K
K
K
K
K
K
K
K
K
K
K
K
K
K
K
K
K
K
K
K
K
K
K
K
K
K
K
K
K
K
K
K
B
W
h
W
B
K
K
K
K
K
K
"}
(6,1,1) = {"
K
K
K
K
K
K
K
K
K
K
K
K
K
K
K
K
K
K
K
K
K
K
K
K
K
K
K
K
K
K
K
K
K
K
B
W
i
W
B
K
K
K
K
K
K
"}
(7,1,1) = {"
K
K
K
K
K
K
K
K
K
K
K
K
K
K
K
K
K
K
K
K
K
K
K
K
K
K
K
K
K
K
K
B
B
B
B
W
h
W
B
B
B
B
B
K
K
"}
(8,1,1) = {"
K
K
K
K
K
K
K
K
K
K
K
K
K
K
K
K
K
K
K
K
K
K
K
K
K
K
K
K
K
K
B
B
W
W
W
W
h
W
W
W
W
W
B
B
K
"}
(9,1,1) = {"
K
K
K
K
K
K
K
K
K
K
K
K
K
K
K
K
K
K
K
K
K
K
K
K
K
K
K
K
K
K
B
W
W
h
h
h
h
h
h
h
h
W
W
B
K
"}
(10,1,1) = {"
K
K
K
K
K
K
K
K
K
K
K
K
K
K
K
K
K
K
K
K
K
K
K
K
K
K
K
K
K
K
B
W
h
h
W
W
W
W
W
W
W
h
W
B
K
"}
(11,1,1) = {"
K
K
K
K
K
K
K
K
K
K
K
K
K
K
K
K
K
K
K
K
K
K
K
K
K
K
K
K
K
K
B
W
i
W
W
B
B
B
B
B
W
i
W
B
K
"}
(12,1,1) = {"
K
K
K
K
K
K
K
K
K
K
K
K
K
K
K
K
K
K
K
K
K
K
K
K
K
K
K
K
K
K
B
W
h
W
B
B
W
W
W
W
W
h
W
B
K
"}
(13,1,1) = {"
K
K
K
K
K
K
K
K
K
K
K
K
K
K
K
K
K
K
K
K
K
K
K
K
K
K
K
K
K
K
B
W
h
W
B
W
W
h
h
h
h
W
W
B
K
"}
(14,1,1) = {"
K
K
K
K
K
K
K
K
K
K
K
K
K
K
K
K
K
K
K
K
K
K
K
K
K
K
K
K
K
K
B
W
z
W
B
W
h
W
W
W
W
W
B
B
K
"}
(15,1,1) = {"
K
K
K
K
K
K
K
K
K
K
K
K
K
K
K
K
K
K
K
K
K
K
K
K
K
K
K
K
K
K
B
B
B
B
B
W
h
W
B
B
B
B
B
K
K
"}
(16,1,1) = {"
K
K
K
K
K
K
K
K
K
K
K
K
K
K
K
K
K
K
K
K
K
K
K
K
K
K
K
K
K
K
K
K
K
K
B
W
h
W
W
W
W
W
B
K
K
"}
(17,1,1) = {"
K
K
K
K
K
K
K
K
K
K
K
K
K
K
K
K
K
K
K
K
K
K
K
K
K
K
K
K
K
K
K
K
K
K
B
W
W
h
i
h
h
X
B
K
K
"}
(18,1,1) = {"
K
K
K
K
K
K
K
K
K
K
K
K
K
K
K
K
K
K
K
K
K
K
K
K
K
K
K
K
K
K
K
K
K
K
B
B
W
W
W
W
W
W
B
K
K
"}
(19,1,1) = {"
K
K
K
K
K
K
K
K
K
K
K
K
K
K
K
K
K
K
K
K
K
K
K
K
K
K
K
K
K
K
K
K
K
K
K
B
B
B
B
B
B
B
B
K
K
"}
(20,1,1) = {"
K
K
K
K
K
K
K
K
K
K
K
K
K
K
K
K
K
K
K
K
K
K
K
K
K
K
K
K
K
K
K
K
K
K
K
K
K
K
K
K
K
K
K
K
K
"}
(21,1,1) = {"
K
K
K
K
K
K
K
K
K
K
K
K
K
K
K
K
K
K
K
K
K
K
K
K
K
K
K
K
K
K
N
N
N
N
N
K
K
K
K
K
K
K
K
K
K
"}
(22,1,1) = {"
K
K
K
K
K
K
K
K
K
K
K
K
K
K
K
K
K
K
K
K
K
K
K
K
K
K
K
K
K
K
N
s
F
s
N
N
N
K
K
K
K
K
K
K
K
"}
(23,1,1) = {"
K
K
K
K
K
K
K
K
K
K
K
K
K
K
K
K
K
K
K
K
K
K
K
K
K
K
K
K
K
K
n
g
g
g
g
g
N
N
K
K
K
K
K
K
K
"}
(24,1,1) = {"
K
K
K
K
K
K
K
K
K
K
K
K
K
K
K
K
K
K
K
K
K
K
K
K
K
K
K
K
K
K
n
g
G
g
g
g
g
N
K
K
K
K
K
K
K
"}
(25,1,1) = {"
K
K
K
K
K
K
K
K
K
K
K
K
K
K
K
K
K
K
K
K
K
K
K
K
K
K
K
K
K
K
n
g
g
g
g
g
g
N
K
K
K
K
K
K
K
"}
(26,1,1) = {"
K
K
K
K
K
K
K
K
K
K
K
K
K
K
K
K
K
K
K
K
K
K
K
K
K
K
K
N
n
n
N
N
N
N
N
s
s
N
N
N
N
N
N
K
K
"}
(27,1,1) = {"
K
K
K
K
K
K
K
K
K
K
K
K
K
K
K
K
K
K
K
K
K
K
K
K
K
K
N
N
g
g
s
g
g
g
N
g
g
a
N
s
g
g
N
N
K
"}
(28,1,1) = {"
K
K
K
K
K
K
K
K
K
K
K
K
K
K
K
K
K
K
K
K
K
K
K
K
K
K
N
g
g
g
s
g
G
g
N
g
g
c
N
T
g
g
g
N
K
"}
(29,1,1) = {"
K
K
K
K
K
K
K
K
K
K
K
K
K
K
K
K
K
K
K
K
K
K
K
K
K
K
n
g
g
g
s
g
g
g
N
g
g
a
N
s
g
g
g
n
K
"}
(30,1,1) = {"
K
K
K
K
K
K
K
K
K
K
K
K
K
K
K
K
K
K
K
K
K
K
K
K
K
K
n
g
g
g
N
s
J
s
N
g
g
N
N
N
g
G
g
n
K
"}
(31,1,1) = {"
K
K
K
K
K
K
K
K
K
K
K
K
K
K
K
K
K
K
K
K
K
K
K
K
K
K
n
g
g
g
N
f
f
f
N
g
g
g
s
g
g
g
g
n
K
"}
(32,1,1) = {"
K
K
K
K
K
K
K
K
K
K
K
K
K
K
K
K
K
K
K
K
K
K
K
K
K
K
n
g
g
g
g
g
g
g
n
g
g
g
s
g
g
g
g
N
K
"}
(33,1,1) = {"
K
K
K
K
K
K
K
K
K
K
K
K
K
K
K
K
K
K
K
K
K
K
K
K
K
K
N
g
g
g
g
g
g
g
n
g
g
g
s
g
g
g
N
N
K
"}
(34,1,1) = {"
K
K
K
K
K
K
K
K
K
K
K
K
K
K
K
K
K
K
K
K
K
K
K
K
K
K
N
N
a
c
a
N
s
s
N
s
s
N
N
n
n
n
N
K
K
"}
(35,1,1) = {"
K
K
K
K
K
K
K
K
K
K
K
K
K
K
K
K
K
K
K
K
K
K
K
K
K
K
K
N
N
N
N
N
O
O
N
O
O
N
K
K
K
K
K
K
K
"}
(36,1,1) = {"
K
K
K
K
K
K
K
K
K
K
K
K
K
K
K
K
K
K
K
K
K
K
K
K
K
K
K
K
K
K
K
N
O
O
M
O
O
N
K
K
K
K
K
K
K
"}
(37,1,1) = {"
K
K
K
K
K
K
K
K
K
K
K
K
K
K
K
K
K
K
K
K
K
K
K
K
K
K
K
K
K
K
K
N
N
O
O
O
N
N
K
K
K
K
K
K
K
"}
(38,1,1) = {"
K
K
K
K
K
K
K
K
K
K
K
K
K
K
K
K
K
K
K
K
K
K
K
K
K
K
K
K
K
K
K
K
N
n
n
n
N
K
K
K
K
K
K
K
K
"}
(39,1,1) = {"
K
K
K
K
K
K
K
K
K
K
K
K
K
K
K
K
K
K
K
K
K
K
K
K
K
K
K
K
K
K
K
K
K
K
K
K
K
K
K
K
K
K
K
K
K
"}
(40,1,1) = {"
K
K
K
K
K
K
K
K
K
K
K
K
K
K
K
K
K
K
K
K
K
K
K
K
K
K
K
K
K
K
K
K
K
K
K
K
K
K
K
K
K
K
K
K
K
"}
(41,1,1) = {"
K
K
K
K
K
K
K
K
K
K
K
K
K
K
K
K
K
K
K
K
K
K
K
K
K
K
K
K
K
K
K
K
K
K
K
K
K
K
K
K
K
K
K
K
K
"}
(42,1,1) = {"
K
K
K
K
K
K
K
K
K
K
K
K
K
K
K
K
K
K
K
K
K
K
K
K
K
K
K
K
K
K
K
K
K
K
K
K
K
K
K
K
K
K
K
K
K
"}
(43,1,1) = {"
K
K
K
K
K
K
K
K
K
K
K
K
K
K
K
K
K
K
K
K
K
K
K
K
K
K
K
K
K
K
K
K
K
K
K
K
K
K
K
K
K
K
K
K
K
"}
(44,1,1) = {"
K
K
K
K
K
K
K
K
K
K
K
K
K
K
K
K
K
K
K
K
K
K
K
K
K
K
K
K
K
K
K
K
K
K
K
K
K
K
K
K
K
K
K
K
K
"}
(45,1,1) = {"
K
K
K
K
K
K
K
K
K
K
K
K
K
K
K
K
K
K
K
K
K
K
K
K
K
K
K
K
K
K
K
K
K
K
K
K
K
K
K
K
K
K
K
K
K
"}
