//MAP CONVERTED BY dmm2tgm.py THIS HEADER COMMENT PREVENTS RECONVERSION, DO NOT REMOVE
"a" = (
/turf/environment/space,
/area/space)
"q" = (
/turf/unsimulated/wall/fakealien,
/area/custom/arena)
"v" = (
/turf/unsimulated/floor/fakealien,
/area/custom/arena)
"y" = (
/obj/effect/landmark/instagib_arena/sinner,
/turf/unsimulated/floor/fakealien,
/area/custom/arena)
"H" = (
/obj/structure/alien{
	desc = "It looks like a weird egg";
	icon_state = "egg";
	name = "egg"
	},
/turf/unsimulated/floor/fakealien,
/area/custom/arena)
"O" = (
/turf/unsimulated/floor/fakealien/weednode,
/area/custom/arena)
"R" = (
/obj/structure/alien/air_plant,
/turf/unsimulated/floor/fakealien,
/area/custom/arena)
"U" = (
/obj/effect/landmark/instagib_arena/sinner,
/turf/unsimulated/floor/fakealien/weednode,
/area/custom/arena)
"V" = (
/turf/unsimulated/wall/fakealienmembrane,
/area/custom/arena)

(1,1,1) = {"
q
q
q
q
q
q
q
a
a
q
q
q
q
q
q
q
a
a
q
q
q
q
q
q
q
"}
(2,1,1) = {"
q
v
v
v
O
v
q
q
q
q
v
v
v
v
H
q
q
q
q
v
v
v
v
v
q
"}
(3,1,1) = {"
q
O
U
v
R
v
v
O
O
v
v
v
y
v
v
q
v
v
V
O
R
y
O
v
q
"}
(4,1,1) = {"
q
O
v
q
V
q
v
v
O
O
O
q
q
V
v
v
v
v
q
v
v
v
O
O
q
"}
(5,1,1) = {"
q
O
v
q
v
v
v
v
q
v
O
v
q
v
v
O
U
O
v
v
q
q
v
v
q
"}
(6,1,1) = {"
q
v
v
v
v
v
y
H
q
q
v
v
v
v
v
O
v
v
q
v
v
v
v
v
q
"}
(7,1,1) = {"
q
q
q
v
v
v
v
v
V
v
v
v
q
q
q
v
q
q
q
v
y
v
q
q
q
"}
(8,1,1) = {"
a
q
v
v
q
v
q
q
q
v
y
v
v
V
v
v
v
v
q
q
v
O
v
q
a
"}
(9,1,1) = {"
a
q
v
v
V
O
v
O
q
q
v
v
v
q
v
v
y
v
v
v
v
O
O
q
a
"}
(10,1,1) = {"
q
q
v
q
q
O
O
v
O
O
v
q
R
v
v
O
O
v
v
q
q
q
v
q
q
"}
(11,1,1) = {"
q
H
v
v
q
v
O
U
O
v
q
q
q
q
V
q
q
O
V
q
v
v
v
H
q
"}
(12,1,1) = {"
q
v
O
O
q
v
O
O
v
v
v
v
v
q
v
v
v
v
v
q
v
v
v
v
q
"}
(13,1,1) = {"
q
v
U
v
v
v
v
q
q
R
v
v
v
v
v
y
v
v
v
q
v
O
y
q
q
"}
(14,1,1) = {"
q
v
O
v
q
q
V
q
v
O
v
v
q
v
v
v
v
v
v
v
v
O
O
v
q
"}
(15,1,1) = {"
q
v
v
v
v
q
H
v
v
O
q
q
q
q
q
v
q
q
V
q
v
v
O
R
q
"}
(16,1,1) = {"
q
q
q
q
v
v
v
v
U
O
v
q
v
v
v
O
v
v
v
q
V
q
v
q
q
"}
(17,1,1) = {"
a
q
v
v
O
v
q
v
v
O
v
v
O
V
v
O
O
U
v
v
v
v
v
q
a
"}
(18,1,1) = {"
a
q
v
v
y
v
q
V
q
v
v
v
v
q
q
q
v
v
v
q
v
y
v
q
a
"}
(19,1,1) = {"
q
q
v
v
v
q
q
v
v
O
q
v
q
q
v
v
v
v
H
q
v
v
q
q
q
"}
(20,1,1) = {"
q
H
v
q
v
v
q
v
O
v
V
v
v
v
v
v
q
q
q
q
v
v
v
v
q
"}
(21,1,1) = {"
q
v
O
q
q
R
v
O
U
q
q
q
O
O
U
v
v
q
v
v
v
q
q
O
q
"}
(22,1,1) = {"
q
v
O
v
q
v
v
O
v
v
v
v
O
v
v
R
v
V
v
O
v
v
v
O
q
"}
(23,1,1) = {"
q
v
U
O
v
v
q
v
v
q
v
v
v
V
v
O
v
v
v
v
y
O
O
v
q
"}
(24,1,1) = {"
q
v
v
O
O
v
q
q
q
q
v
v
H
q
v
q
q
q
q
v
v
O
v
H
q
"}
(25,1,1) = {"
q
q
q
q
q
q
q
a
a
q
q
q
q
q
q
q
a
a
q
q
q
q
q
q
q
"}
