//MAP CONVERTED BY dmm2tgm.py THIS HEADER COMMENT PREVENTS RECONVERSION, DO NOT REMOVE
"a" = (
/turf/environment/space,
/area/space)
"f" = (
/turf/unsimulated/floor{
	icon = 'icons/turf/floors/smooth/hardfloor_3.dmi';
	icon_state = "center_8"
	},
/area/custom/arena)
"s" = (
/obj/structure/static_portal{
	color = "#ff4100";
	id = 1
	},
/turf/unsimulated/floor{
	icon = 'icons/turf/floors/smooth/hardfloor_3.dmi';
	icon_state = "center_8"
	},
/area/custom/arena)
"w" = (
/obj/structure/static_portal{
	color = "#4572e3";
	id = 2
	},
/turf/unsimulated/floor{
	icon = 'icons/turf/floors/smooth/hardfloor_3.dmi';
	icon_state = "center_8"
	},
/area/custom/arena)
"L" = (
/turf/unsimulated/wall/like_a_normal/red,
/area/custom/arena)
"W" = (
/obj/effect/landmark/instagib_arena/sinner,
/turf/unsimulated/floor{
	icon = 'icons/turf/floors/smooth/hardfloor_3.dmi';
	icon_state = "center_8"
	},
/area/custom/arena)

(1,1,1) = {"
a
a
a
a
a
a
a
a
a
a
L
L
L
L
L
L
L
a
a
a
a
a
a
a
a
a
a
"}
(2,1,1) = {"
a
a
a
a
a
a
a
L
L
L
L
f
f
f
f
f
L
L
L
L
a
a
a
a
a
a
a
"}
(3,1,1) = {"
a
a
a
a
a
L
L
L
f
f
f
f
f
W
f
f
f
f
f
L
L
L
a
a
a
a
a
"}
(4,1,1) = {"
a
a
a
L
L
L
f
L
f
f
f
f
f
f
f
f
f
f
f
L
f
L
L
L
a
a
a
"}
(5,1,1) = {"
a
a
a
L
f
f
f
f
f
f
f
L
f
s
f
L
f
f
f
f
f
f
f
L
a
a
a
"}
(6,1,1) = {"
a
a
L
L
f
W
f
f
f
f
f
L
L
L
L
L
f
f
f
f
f
W
f
L
L
a
a
"}
(7,1,1) = {"
a
a
L
f
f
f
f
f
f
f
f
f
f
L
f
f
f
f
f
f
f
f
f
f
L
a
a
"}
(8,1,1) = {"
a
L
L
L
f
f
f
L
L
f
f
f
f
f
f
f
f
f
L
L
f
f
f
L
L
L
a
"}
(9,1,1) = {"
a
L
f
f
f
f
f
L
f
f
f
f
f
f
f
f
f
f
f
L
f
f
f
f
f
L
a
"}
(10,1,1) = {"
a
L
f
f
f
f
f
f
f
W
f
L
f
f
f
L
f
W
f
f
f
f
f
f
f
L
a
"}
(11,1,1) = {"
L
L
f
f
f
f
f
f
f
f
f
L
f
f
f
L
f
f
f
f
f
f
f
f
f
L
L
"}
(12,1,1) = {"
L
f
f
f
L
L
f
f
f
L
L
L
f
f
f
L
L
L
f
f
f
L
L
f
f
f
L
"}
(13,1,1) = {"
L
f
f
f
f
L
f
f
f
f
f
f
f
f
f
f
f
f
f
f
f
L
f
f
f
f
L
"}
(14,1,1) = {"
L
f
W
f
w
L
L
f
f
f
f
f
f
W
f
f
f
f
f
f
L
L
w
f
W
f
L
"}
(15,1,1) = {"
L
f
f
f
f
L
f
f
f
f
f
f
f
f
f
f
f
f
f
f
f
L
f
f
f
f
L
"}
(16,1,1) = {"
L
f
f
f
L
L
f
f
f
L
L
L
f
f
f
L
L
L
f
f
f
L
L
f
f
f
L
"}
(17,1,1) = {"
L
L
f
f
f
f
f
f
f
f
f
L
f
f
f
L
f
f
f
f
f
f
f
f
f
L
L
"}
(18,1,1) = {"
a
L
f
f
f
f
f
f
f
W
f
L
f
f
f
L
f
W
f
f
f
f
f
f
f
L
a
"}
(19,1,1) = {"
a
L
f
f
f
f
f
L
f
f
f
f
f
f
f
f
f
f
f
L
f
f
f
f
f
L
a
"}
(20,1,1) = {"
a
L
L
L
f
f
f
L
L
f
f
f
f
f
f
f
f
f
L
L
f
f
f
L
L
L
a
"}
(21,1,1) = {"
a
a
L
f
f
f
f
f
f
f
f
f
f
L
f
f
f
f
f
f
f
f
f
f
L
a
a
"}
(22,1,1) = {"
a
a
L
L
f
W
f
f
f
f
f
L
L
L
L
L
f
f
f
f
f
W
f
L
L
a
a
"}
(23,1,1) = {"
a
a
a
L
f
f
f
f
f
f
f
L
f
s
f
L
f
f
f
f
f
f
f
L
a
a
a
"}
(24,1,1) = {"
a
a
a
L
L
L
f
L
f
f
f
f
f
f
f
f
f
f
f
L
f
L
L
L
a
a
a
"}
(25,1,1) = {"
a
a
a
a
a
L
L
L
f
f
f
f
f
W
f
f
f
f
f
L
L
L
a
a
a
a
a
"}
(26,1,1) = {"
a
a
a
a
a
a
a
L
L
L
L
f
f
f
f
f
L
L
L
L
a
a
a
a
a
a
a
"}
(27,1,1) = {"
a
a
a
a
a
a
a
a
a
a
L
L
L
L
L
L
L
a
a
a
a
a
a
a
a
a
a
"}
