//MAP CONVERTED BY dmm2tgm.py THIS HEADER COMMENT PREVENTS RECONVERSION, DO NOT REMOVE
"a" = (
/turf/environment/space,
/area/space)
"d" = (
/obj/effect/landmark/instagib_dm/sinner,
/turf/simulated/shuttle/floor/evac/eng1,
/area/space)
"f" = (
/obj/effect/landmark/instagib_dm/sinner,
/turf/simulated/shuttle/floor/vox,
/area/space)
"h" = (
/turf/simulated/shuttle/floor/vox{
	icon_state = "floorcatwalk"
	},
/area/space)
"i" = (
/obj/structure/shuttle/engine/propulsion{
	dir = 4;
	icon_state = "burst_l"
	},
/turf/environment/space,
/area/space)
"j" = (
/obj/machinery/vending/cola,
/turf/simulated/shuttle/floor/evac/eng2,
/area/space)
"l" = (
/obj/structure/shuttle/engine/propulsion{
	dir = 4;
	icon_state = "burst_r"
	},
/turf/environment/space,
/area/space)
"o" = (
/obj/machinery/vending/coffee,
/turf/simulated/shuttle/floor/vox,
/area/space)
"p" = (
/obj/structure/window/fulltile/reinforced{
	grilled = 1;
	icon_state = "gr_window_reinforced"
	},
/turf/simulated/shuttle/floor/evac,
/area/space)
"r" = (
/obj/effect/landmark/instagib_dm/sinner,
/turf/simulated/shuttle/floor/vox{
	icon_state = "floorcatwalk"
	},
/area/space)
"u" = (
/turf/unsimulated/wall/like_a_normal/red,
/area/space)
"v" = (
/obj/structure/shuttle/engine/propulsion{
	icon_state = "burst_l"
	},
/turf/environment/space,
/area/space)
"x" = (
/obj/structure/shuttle/engine/propulsion,
/turf/environment/space,
/area/space)
"E" = (
/turf/simulated/shuttle/floor/vox,
/area/space)
"F" = (
/obj/structure/shuttle/engine/heater{
	dir = 4;
	icon_state = "heater1"
	},
/turf/simulated/shuttle/floor/vox{
	icon_state = "floorplace"
	},
/area/space)
"J" = (
/obj/structure/window/fulltile/reinforced/indestructible{
	icon_state = "gr_window_reinforced"
	},
/turf/environment/space,
/area/space)
"K" = (
/obj/structure/shuttle/engine/propulsion{
	icon_state = "burst_r"
	},
/turf/environment/space,
/area/space)
"L" = (
/obj/machinery/vending/cola,
/turf/simulated/shuttle/floor/vox,
/area/space)
"M" = (
/turf/simulated/shuttle/floor/evac/eng2,
/area/space)
"P" = (
/obj/machinery/vending/chinese,
/turf/simulated/shuttle/floor/vox,
/area/space)
"Q" = (
/turf/simulated/shuttle/floor/evac/eng1,
/area/space)
"S" = (
/obj/structure/shuttle/engine/heater{
	icon_state = "heater1"
	},
/turf/simulated/shuttle/floor/evac/eng1,
/area/space)
"T" = (
/obj/machinery/vending/coffee,
/turf/simulated/shuttle/floor/evac/eng2,
/area/space)
"X" = (
/obj/structure/shuttle/engine/propulsion{
	dir = 4
	},
/turf/environment/space,
/area/space)
"Y" = (
/obj/machinery/vending/chinese,
/turf/simulated/shuttle/floor/evac/eng2,
/area/space)
"Z" = (
/turf/unsimulated/wall/like_a_normal,
/area/space)

(1,1,1) = {"
a
a
a
a
a
a
a
a
a
a
a
a
a
a
a
a
a
a
a
a
a
a
a
a
a
a
a
a
a
a
a
a
a
a
a
a
a
a
a
a
a
a
a
a
a
"}
(2,1,1) = {"
a
a
a
a
a
a
a
a
a
a
a
a
a
a
a
a
a
a
a
a
a
a
a
a
a
a
a
a
a
a
a
a
a
a
a
a
a
a
a
a
a
a
a
a
a
"}
(3,1,1) = {"
a
a
a
a
a
a
a
Z
J
J
J
Z
a
a
a
a
a
a
a
a
a
a
a
a
a
a
a
a
a
a
a
a
a
a
a
a
a
a
a
a
a
a
a
a
a
"}
(4,1,1) = {"
a
a
a
a
a
a
a
J
M
Y
M
Z
Z
a
a
a
a
a
a
a
a
a
a
a
a
a
a
a
a
a
a
a
a
a
a
a
a
a
a
a
a
a
a
a
a
"}
(5,1,1) = {"
a
a
a
a
a
a
a
J
M
M
M
M
J
a
a
a
a
a
a
a
a
a
a
a
a
a
a
a
a
a
a
a
a
a
a
a
a
a
a
a
a
a
a
a
a
"}
(6,1,1) = {"
a
a
a
a
a
a
Z
Z
Q
d
Q
M
J
a
a
a
a
a
a
a
a
a
a
a
a
a
a
a
a
a
a
a
a
a
a
a
a
a
a
a
a
a
a
a
a
"}
(7,1,1) = {"
a
a
a
a
a
a
J
M
Q
M
Q
Q
Z
Z
a
a
a
a
a
a
a
a
a
a
a
a
a
a
a
a
a
a
a
a
a
a
a
a
a
a
a
a
a
a
a
"}
(8,1,1) = {"
a
a
a
a
a
a
J
M
Q
M
M
Q
M
Z
Z
Z
a
a
a
a
a
a
a
a
a
a
a
a
a
a
a
a
a
a
a
a
a
a
a
a
a
a
a
a
a
"}
(9,1,1) = {"
a
a
a
a
a
Z
Z
Z
Q
Z
Z
Q
M
Z
Z
Z
J
J
J
Z
a
a
a
a
a
a
a
a
a
a
a
a
a
a
a
a
a
a
a
a
a
a
a
a
a
"}
(10,1,1) = {"
a
a
a
a
a
J
M
M
Q
M
M
Q
M
Z
M
M
M
M
M
Z
Z
Z
Z
Z
a
a
a
a
a
u
u
a
a
a
u
u
a
a
a
a
a
a
a
a
a
"}
(11,1,1) = {"
a
a
a
a
a
J
M
Q
Q
Q
d
Q
Q
Q
Q
Q
Q
M
M
M
M
J
S
v
a
a
a
a
a
u
u
a
a
a
u
u
a
a
a
a
a
a
a
a
a
"}
(12,1,1) = {"
a
a
a
a
a
Z
Z
Q
Z
M
M
Q
Q
Q
Q
Q
Q
Q
d
M
M
J
S
K
a
a
a
a
a
u
u
a
a
a
u
u
a
a
a
a
a
a
a
a
a
"}
(13,1,1) = {"
a
a
a
a
Z
Z
M
Q
Z
M
M
Q
Q
Z
M
M
Q
Q
M
M
Z
Z
Z
a
a
a
a
a
u
u
u
a
a
a
u
u
u
a
a
a
a
a
a
a
a
"}
(14,1,1) = {"
a
a
a
a
Z
M
M
Q
Z
Z
Z
M
Q
Z
Z
Z
Q
Q
Z
Z
Z
S
v
a
a
a
a
a
u
u
u
a
a
a
u
u
u
a
a
a
a
a
a
a
a
"}
(15,1,1) = {"
a
a
a
a
J
M
M
Q
M
p
M
M
Q
M
M
M
Q
Q
M
M
J
S
x
a
a
a
a
a
u
u
a
a
a
a
a
u
u
a
a
a
a
a
a
a
a
"}
(16,1,1) = {"
a
a
a
a
J
T
Q
d
M
p
M
Q
Q
d
Q
Q
Q
Q
Q
M
J
S
x
a
a
a
a
a
u
u
a
a
a
a
a
u
u
a
a
a
a
a
a
a
a
"}
(17,1,1) = {"
a
a
a
a
J
M
M
Q
M
p
M
M
Q
M
M
M
Q
Q
M
M
J
S
x
a
a
a
a
u
u
u
a
a
a
a
a
u
u
u
a
a
a
a
a
a
a
"}
(18,1,1) = {"
a
a
a
a
Z
M
M
Q
Z
Z
Z
M
Q
Z
Z
Z
Q
Q
Z
Z
Z
S
K
a
a
a
a
u
u
u
a
a
a
a
a
u
u
u
a
a
a
a
a
a
a
"}
(19,1,1) = {"
a
a
a
a
Z
Z
M
Q
Z
M
M
Q
Q
Z
M
M
Q
Q
M
M
Z
Z
Z
a
a
a
a
u
u
u
u
a
a
a
u
u
u
u
a
a
a
a
a
a
a
"}
(20,1,1) = {"
a
a
a
a
a
Z
Z
Q
Z
M
M
Q
Q
Q
Q
Q
Q
Q
d
M
M
J
S
v
a
a
a
u
u
u
u
J
J
J
u
u
u
u
a
a
a
a
a
a
a
"}
(21,1,1) = {"
a
a
a
a
a
J
M
Q
Q
Q
d
Q
Q
Q
Q
Q
Q
M
M
M
M
J
S
K
a
a
u
u
u
u
u
E
E
E
u
u
u
u
u
a
a
a
a
a
a
"}
(22,1,1) = {"
a
a
a
a
a
J
M
M
Q
M
M
Q
M
Z
M
M
M
M
M
Z
Z
Z
Z
Z
a
a
J
E
L
u
E
E
E
E
E
u
E
E
J
a
a
a
a
a
a
"}
(23,1,1) = {"
a
a
a
a
a
Z
Z
Z
Q
Z
Z
Q
M
Z
Z
Z
J
J
J
Z
a
a
a
a
a
a
J
E
h
h
h
h
r
h
h
h
h
E
J
a
a
a
a
a
a
"}
(24,1,1) = {"
a
a
a
a
a
a
J
M
Q
M
M
Q
M
Z
Z
Z
a
a
a
a
a
a
a
a
a
u
u
E
h
u
E
E
h
E
E
u
h
E
u
u
a
a
a
a
a
"}
(25,1,1) = {"
a
a
a
a
a
a
J
M
Q
M
Q
Q
Z
Z
a
a
a
a
a
a
a
a
a
a
a
J
E
E
h
u
u
E
h
E
u
u
h
E
E
J
a
a
a
a
a
"}
(26,1,1) = {"
a
a
a
a
a
a
Z
Z
Q
d
Q
M
J
a
a
a
a
a
a
a
a
a
a
a
a
J
E
E
h
E
u
u
h
u
u
E
h
f
E
J
a
a
a
a
a
"}
(27,1,1) = {"
a
a
a
a
a
a
a
J
M
M
M
M
J
a
a
a
a
a
a
a
a
a
a
a
a
J
E
E
h
E
u
E
h
E
u
E
h
E
E
J
a
a
a
a
a
"}
(28,1,1) = {"
a
a
a
a
a
a
a
J
M
j
M
Z
Z
a
a
a
a
a
a
a
a
a
a
a
u
u
u
h
h
h
h
h
h
h
h
h
h
h
u
u
u
a
a
a
a
"}
(29,1,1) = {"
a
a
a
a
a
a
a
Z
J
J
J
Z
a
a
a
a
a
a
a
a
a
a
a
a
J
E
h
h
h
h
h
h
h
h
h
h
h
h
h
E
J
a
a
a
a
"}
(30,1,1) = {"
a
a
a
a
a
a
a
a
a
a
a
a
a
a
a
a
a
a
a
a
a
a
a
a
J
E
h
h
f
E
u
E
h
E
u
E
E
h
h
o
J
a
a
a
a
"}
(31,1,1) = {"
a
a
a
a
a
a
a
a
a
a
a
a
a
a
a
a
a
a
a
a
a
a
a
a
J
E
h
h
E
E
u
E
h
E
u
E
E
h
h
E
J
a
a
a
a
"}
(32,1,1) = {"
a
a
a
a
a
a
a
a
a
a
a
a
a
a
a
a
a
a
a
a
a
a
a
u
u
u
h
h
u
u
u
E
h
E
u
u
u
h
h
u
u
u
a
a
a
"}
(33,1,1) = {"
a
a
a
a
a
a
a
a
a
a
a
a
a
a
a
a
a
a
a
a
a
a
a
J
E
E
h
h
E
E
u
E
r
E
u
E
E
h
h
E
E
J
a
a
a
"}
(34,1,1) = {"
a
a
a
a
a
a
a
a
a
a
a
a
a
a
a
a
a
a
a
a
a
a
a
J
E
E
h
h
E
E
u
E
h
E
u
E
f
h
h
E
E
J
a
a
a
"}
(35,1,1) = {"
a
a
a
a
a
a
a
a
a
a
a
a
a
a
a
a
a
a
a
a
a
a
a
J
E
E
h
h
h
h
h
h
h
h
h
h
h
h
h
E
E
J
a
a
a
"}
(36,1,1) = {"
a
a
a
a
a
a
a
a
a
a
a
a
a
a
a
a
a
a
a
a
a
a
a
u
u
E
r
h
h
h
h
h
h
h
h
h
h
h
h
E
u
u
a
a
a
"}
(37,1,1) = {"
a
a
a
a
a
a
a
a
a
a
a
a
a
a
a
a
a
a
a
a
a
a
a
a
J
E
E
E
E
E
u
E
h
E
u
E
E
E
E
E
J
a
a
a
a
"}
(38,1,1) = {"
a
a
a
a
a
a
a
a
a
a
a
a
a
a
a
a
a
a
a
a
a
a
a
a
u
J
J
u
E
E
u
E
h
E
u
E
E
u
J
J
u
a
a
a
a
"}
(39,1,1) = {"
a
a
a
a
a
a
a
a
a
a
a
a
a
a
a
a
a
a
a
a
a
a
a
a
u
F
F
u
J
J
u
E
P
E
u
J
J
u
F
F
u
a
a
a
a
"}
(40,1,1) = {"
a
a
a
a
a
a
a
a
a
a
a
a
a
a
a
a
a
a
a
a
a
a
a
a
u
l
i
u
F
F
u
J
J
J
u
F
F
u
l
i
u
a
a
a
a
"}
(41,1,1) = {"
a
a
a
a
a
a
a
a
a
a
a
a
a
a
a
a
a
a
a
a
a
a
a
a
a
a
a
u
l
i
u
F
F
F
u
l
i
u
a
a
a
a
a
a
a
"}
(42,1,1) = {"
a
a
a
a
a
a
a
a
a
a
a
a
a
a
a
a
a
a
a
a
a
a
a
a
a
a
a
a
a
a
u
l
X
i
u
a
a
a
a
a
a
a
a
a
a
"}
(43,1,1) = {"
a
a
a
a
a
a
a
a
a
a
a
a
a
a
a
a
a
a
a
a
a
a
a
a
a
a
a
a
a
a
a
a
a
a
a
a
a
a
a
a
a
a
a
a
a
"}
(44,1,1) = {"
a
a
a
a
a
a
a
a
a
a
a
a
a
a
a
a
a
a
a
a
a
a
a
a
a
a
a
a
a
a
a
a
a
a
a
a
a
a
a
a
a
a
a
a
a
"}
(45,1,1) = {"
a
a
a
a
a
a
a
a
a
a
a
a
a
a
a
a
a
a
a
a
a
a
a
a
a
a
a
a
a
a
a
a
a
a
a
a
a
a
a
a
a
a
a
a
a
"}
