//MAP CONVERTED BY dmm2tgm.py THIS HEADER COMMENT PREVENTS RECONVERSION, DO NOT REMOVE
"a" = (
/obj/structure/inflatable/survival,
/turf/simulated/floor/pod,
/area/custom/survivalpod/bar)
"b" = (
/turf/simulated/floor/pod,
/area/custom/survivalpod/bar)
"c" = (
/obj/machinery/light/small,
/turf/simulated/floor/pod,
/area/custom/survivalpod/bar)
"d" = (
/obj/structure/table/woodentable/fancy,
/obj/machinery/chem_dispenser/beer{
	pixel_y = 4
	},
/turf/simulated/floor/pod,
/area/custom/survivalpod/bar)
"e" = (
/obj/structure/table/reinforced,
/obj/item/weapon/reagent_containers/food/snacks/cakeslice/apple,
/turf/simulated/floor/pod,
/area/custom/survivalpod/bar)
"h" = (
/obj/structure/table/woodentable/fancy,
/obj/item/weapon/reagent_containers/food/condiment/saltshaker{
	pixel_x = -4;
	pixel_y = 7
	},
/obj/item/weapon/reagent_containers/food/snacks/carrotfries{
	pixel_x = 8
	},
/obj/item/weapon/kitchen/utensil/fork{
	pixel_x = 4
	},
/obj/item/weapon/kitchen/utensil/spoon{
	pixel_x = -9;
	pixel_y = -2
	},
/turf/simulated/floor/carpet/blue,
/area/custom/survivalpod/bar)
"i" = (
/obj/machinery/light{
	dir = 1
	},
/obj/machinery/door/window/westright,
/turf/simulated/floor/pod,
/area/custom/survivalpod/bar)
"j" = (
/obj/structure/table/woodentable/fancy,
/obj/item/weapon/kitchen/utensil/spoon{
	pixel_x = -9;
	pixel_y = -2
	},
/obj/item/weapon/reagent_containers/food/condiment/saltshaker{
	pixel_x = -3
	},
/obj/item/weapon/kitchen/utensil/fork{
	pixel_x = 4
	},
/obj/item/weapon/reagent_containers/food/condiment/peppermill{
	pixel_x = 10;
	pixel_y = 7
	},
/turf/simulated/floor/carpet/blue,
/area/custom/survivalpod/bar)
"k" = (
/obj/machinery/vending/wallmed1{
	layer = 3.1;
	pixel_y = 30
	},
/turf/simulated/floor/pod,
/area/custom/survivalpod/bar)
"l" = (
/obj/structure/table/reinforced,
/obj/item/weapon/reagent_containers/food/snacks/aesirsalad,
/turf/simulated/floor/pod,
/area/custom/survivalpod/bar)
"m" = (
/obj/structure/table/reinforced,
/turf/simulated/floor/pod,
/area/custom/survivalpod/bar)
"n" = (
/obj/structure/stool/bar,
/turf/simulated/floor/pod,
/area/custom/survivalpod/bar)
"p" = (
/obj/machinery/vending/boozeomat{
	req_access = list()
	},
/turf/simulated/floor/pod,
/area/custom/survivalpod/bar)
"t" = (
/obj/structure/table/woodentable/fancy,
/obj/item/weapon/reagent_containers/food/condiment/peppermill{
	pixel_x = -7;
	pixel_y = 6
	},
/obj/item/weapon/kitchen/utensil/spoon,
/obj/item/weapon/kitchen/utensil/fork{
	pixel_x = 4;
	pixel_y = 7
	},
/turf/simulated/floor/carpet/blue,
/area/custom/survivalpod/bar)
"u" = (
/obj/machinery/light,
/turf/simulated/floor/pod,
/area/custom/survivalpod/bar)
"x" = (
/obj/structure/stool/bar,
/obj/machinery/light{
	dir = 8
	},
/turf/simulated/floor/pod,
/area/custom/survivalpod/bar)
"y" = (
/obj/structure/inflatable/door/survival_pod,
/obj/structure/fans/tiny,
/turf/simulated/floor/pod,
/area/custom/survivalpod/bar)
"A" = (
/obj/structure/toilet,
/turf/simulated/floor/pod,
/area/custom/survivalpod/bar)
"B" = (
/obj/structure/table/reinforced,
/obj/item/clothing/mask/cigarette/cigar{
	pixel_x = -5;
	pixel_y = 5
	},
/obj/item/clothing/mask/cigarette/cigar{
	pixel_x = 1;
	pixel_y = 3
	},
/obj/item/clothing/mask/cigarette/cigar{
	pixel_x = 2;
	pixel_y = -2
	},
/turf/simulated/floor/pod,
/area/custom/survivalpod/bar)
"C" = (
/obj/structure/stool/bed/chair/comfy/black,
/turf/simulated/floor/carpet/blue,
/area/custom/survivalpod/bar)
"D" = (
/obj/structure/stool/bed/chair/comfy/black{
	dir = 8
	},
/turf/simulated/floor/carpet/blue,
/area/custom/survivalpod/bar)
"F" = (
/obj/structure/table/reinforced,
/obj/item/device/guitar,
/turf/simulated/floor/carpet/blue,
/area/custom/survivalpod/bar)
"G" = (
/obj/machinery/vending/cigarette,
/turf/simulated/floor/pod,
/area/custom/survivalpod/bar)
"H" = (
/obj/structure/table/reinforced,
/obj/item/toy/cards{
	pixel_x = 4;
	pixel_y = 3
	},
/obj/item/weapon/storage/pill_bottle/dice{
	pixel_x = -5;
	pixel_y = 1
	},
/turf/simulated/floor/pod,
/area/custom/survivalpod/bar)
"I" = (
/obj/structure/sink{
	dir = 8;
	pixel_x = -12
	},
/obj/structure/mirror{
	pixel_x = -28
	},
/obj/structure/dryer{
	dir = 8;
	pixel_x = 6
	},
/turf/simulated/floor/pod,
/area/custom/survivalpod/bar)
"L" = (
/obj/structure/table/reinforced,
/obj/item/weapon/lighter/zippo,
/turf/simulated/floor/pod,
/area/custom/survivalpod/bar)
"M" = (
/obj/structure/stool/bed/chair/comfy/black,
/turf/simulated/floor/pod,
/area/custom/survivalpod/bar)
"P" = (
/obj/structure/inflatable/survival,
/obj/structure/sign/mining/survival{
	dir = 8
	},
/turf/simulated/floor/pod,
/area/custom/survivalpod/bar)
"Q" = (
/obj/structure/table/reinforced,
/obj/item/weapon/reagent_containers/food/drinks/bottle/beer,
/turf/simulated/floor/pod,
/area/custom/survivalpod/bar)
"R" = (
/obj/structure/stool/bed/chair/comfy/black{
	dir = 1
	},
/turf/simulated/floor/carpet/blue,
/area/custom/survivalpod/bar)
"U" = (
/obj/random/vending/cola,
/turf/simulated/floor/pod,
/area/custom/survivalpod/bar)
"W" = (
/obj/random/vending/snack,
/turf/simulated/floor/pod,
/area/custom/survivalpod/bar)
"Y" = (
/obj/structure/table/woodentable/fancy,
/obj/machinery/chem_dispenser/soda{
	pixel_y = 4
	},
/turf/simulated/floor/pod,
/area/custom/survivalpod/bar)
"Z" = (
/obj/machinery/light{
	dir = 4
	},
/turf/simulated/floor/pod,
/area/custom/survivalpod/bar)

(1,1,1) = {"
a
a
a
a
P
y
P
a
a
a
a
"}
(2,1,1) = {"
a
p
b
e
x
b
C
j
R
b
a
"}
(3,1,1) = {"
a
d
b
Q
n
b
b
b
b
b
a
"}
(4,1,1) = {"
a
Y
M
m
n
b
C
h
R
b
a
"}
(5,1,1) = {"
a
b
b
L
n
b
C
t
R
u
a
"}
(6,1,1) = {"
a
i
l
B
n
b
b
b
b
b
a
"}
(7,1,1) = {"
a
b
n
n
b
b
F
a
a
a
a
"}
(8,1,1) = {"
a
k
b
b
b
b
D
a
A
c
a
"}
(9,1,1) = {"
a
b
b
b
b
b
b
a
a
y
a
"}
(10,1,1) = {"
a
G
U
W
H
Z
b
y
I
b
a
"}
(11,1,1) = {"
a
a
a
a
a
a
a
a
a
a
a
"}
