//MAP CONVERTED BY dmm2tgm.py THIS HEADER COMMENT PREVENTS RECONVERSION, DO NOT REMOVE
"a" = (
/obj/structure/inflatable/survival,
/turf/simulated/floor/pod,
/area/custom/survivalpod)
"b" = (
/obj/structure/inflatable/survival,
/obj/structure/sign/mining/survival,
/turf/simulated/floor/pod,
/area/custom/survivalpod)
"c" = (
/turf/simulated/floor/pod,
/area/custom/survivalpod)
"e" = (
/obj/structure/table,
/obj/item/device/guitar,
/obj/machinery/light/small{
	dir = 4
	},
/turf/simulated/floor/carpet/blue,
/area/custom/survivalpod)
"g" = (
/obj/structure/rack,
/obj/item/weapon/storage/toolbox/mechanical,
/turf/simulated/floor/carpet/blue,
/area/custom/survivalpod)
"i" = (
/obj/structure/inflatable/door/survival_pod,
/obj/structure/fans/tiny,
/turf/simulated/floor/pod,
/area/custom/survivalpod)
"j" = (
/obj/structure/window/thin/reinforced{
	dir = 4
	},
/obj/structure/stool/bed/pod,
/obj/item/weapon/bedsheet/blue,
/turf/simulated/floor/pod,
/area/custom/survivalpod)
"l" = (
/obj/machinery/light/small{
	dir = 1
	},
/turf/simulated/floor/carpet/blue,
/area/custom/survivalpod)
"r" = (
/obj/machinery/smartfridge/survival_pod,
/turf/simulated/floor/pod,
/area/custom/survivalpod)
"s" = (
/obj/structure/fans,
/turf/simulated/floor/pod,
/area/custom/survivalpod)
"t" = (
/obj/machinery/sleeper/survival_pod,
/turf/simulated/floor/pod,
/area/custom/survivalpod)
"v" = (
/obj/structure/window/thin/reinforced,
/obj/item/weapon/storage/firstaid/small_firstaid_kit/space,
/obj/structure/table,
/turf/simulated/floor/pod,
/area/custom/survivalpod)
"x" = (
/obj/structure/inflatable/survival,
/obj/structure/sign/mining/survival{
	dir = 4
	},
/turf/simulated/floor/pod,
/area/custom/survivalpod)
"y" = (
/obj/structure/table,
/obj/item/weapon/storage/box/donkpockets{
	pixel_x = -4
	},
/obj/item/weapon/reagent_containers/food/drinks/bottle/vodka{
	pixel_x = 1;
	pixel_y = 5
	},
/obj/item/weapon/reagent_containers/food/drinks/bottle/vodka{
	pixel_x = 8;
	pixel_y = 7
	},
/turf/simulated/floor/carpet/blue,
/area/custom/survivalpod)
"z" = (
/obj/structure/inflatable/survival,
/obj/structure/sign/mining,
/turf/simulated/floor/pod,
/area/custom/survivalpod)
"B" = (
/obj/structure/table,
/obj/machinery/kitchen_machine/microwave{
	pixel_x = -3;
	pixel_y = 6
	},
/turf/simulated/floor/carpet/blue,
/area/custom/survivalpod)
"F" = (
/obj/structure/stool/bed/chair/comfy/white,
/turf/simulated/floor/carpet/blue,
/area/custom/survivalpod)
"G" = (
/obj/structure/reagent_dispensers/fueltank,
/obj/machinery/light/small{
	dir = 8
	},
/turf/simulated/floor/carpet/blue,
/area/custom/survivalpod)
"J" = (
/obj/item/device/gps/computer,
/obj/structure/window/thin/reinforced{
	dir = 4
	},
/turf/simulated/floor/pod,
/area/custom/survivalpod)
"P" = (
/turf/simulated/floor/carpet/blue,
/area/custom/survivalpod)
"U" = (
/obj/structure/inflatable/survival,
/obj/structure/sign/mining/survival{
	dir = 8
	},
/turf/simulated/floor/pod,
/area/custom/survivalpod)
"W" = (
/obj/structure/stool/bed/chair/comfy/white{
	dir = 4
	},
/turf/simulated/floor/carpet/blue,
/area/custom/survivalpod)
"X" = (
/obj/structure/window/thin/reinforced,
/obj/structure/window/thin/reinforced{
	dir = 4
	},
/obj/structure/stool/bed/pod,
/obj/item/weapon/bedsheet/blue,
/turf/simulated/floor/pod,
/area/custom/survivalpod)
"Y" = (
/obj/structure/inflatable/survival,
/obj/structure/sign/mining/survival{
	dir = 1
	},
/turf/simulated/floor/pod,
/area/custom/survivalpod)

(1,1,1) = {"
a
a
a
U
a
a
a
"}
(2,1,1) = {"
a
s
t
v
g
G
a
"}
(3,1,1) = {"
a
r
c
c
P
P
b
"}
(4,1,1) = {"
Y
J
j
X
P
P
i
"}
(5,1,1) = {"
a
l
P
P
P
W
z
"}
(6,1,1) = {"
a
B
y
P
F
e
a
"}
(7,1,1) = {"
a
a
a
x
a
a
a
"}
