//MAP CONVERTED BY dmm2tgm.py THIS HEADER COMMENT PREVENTS RECONVERSION, DO NOT REMOVE
"a" = (
/turf/environment/space,
/area/space)
"f" = (
/turf/unsimulated/floor{
	icon = 'icons/turf/floors/smooth/hardfloor_3.dmi';
	icon_state = "center_8"
	},
/area/custom/arena)
"g" = (
/obj/item/weapon/grenade/syndieminibomb,
/turf/unsimulated/floor{
	icon = 'icons/turf/floors/smooth/hardfloor_3.dmi';
	icon_state = "center_8"
	},
/area/custom/arena)
"r" = (
/obj/random/guns/projectile_handgun,
/turf/unsimulated/floor{
	icon = 'icons/turf/floors/smooth/hardfloor_3.dmi';
	icon_state = "center_8"
	},
/area/custom/arena)
"s" = (
/obj/random/cloth/armor,
/turf/unsimulated/floor{
	icon = 'icons/turf/floors/smooth/hardfloor_3.dmi';
	icon_state = "center_8"
	},
/area/custom/arena)
"t" = (
/obj/random/cloth/helmet,
/turf/unsimulated/floor{
	icon = 'icons/turf/floors/smooth/hardfloor_3.dmi';
	icon_state = "center_8"
	},
/area/custom/arena)
"u" = (
/obj/random/melee,
/turf/unsimulated/floor{
	icon = 'icons/turf/floors/smooth/hardfloor_3.dmi';
	icon_state = "center_8"
	},
/area/custom/arena)
"w" = (
/obj/random/guns/energy_weapon,
/turf/unsimulated/floor{
	icon = 'icons/turf/floors/smooth/hardfloor_3.dmi';
	icon_state = "center_8"
	},
/area/custom/arena)
"L" = (
/turf/unsimulated/wall/like_a_normal/red,
/area/custom/arena)
"P" = (
/obj/random/guns/set_special,
/turf/unsimulated/floor{
	icon = 'icons/turf/floors/smooth/hardfloor_3.dmi';
	icon_state = "center_8"
	},
/area/custom/arena)
"V" = (
/obj/item/weapon/gun/projectile/revolver/rocketlauncher/commando,
/turf/unsimulated/floor{
	icon = 'icons/turf/floors/smooth/hardfloor_3.dmi';
	icon_state = "center_8"
	},
/area/custom/arena)
"W" = (
/obj/effect/landmark/post_round_dm/gladiator{
	name = "Gladiator"
	},
/turf/unsimulated/floor{
	icon = 'icons/turf/floors/smooth/hardfloor_3.dmi';
	icon_state = "center_8"
	},
/area/custom/arena)
"Z" = (
/obj/item/weapon/reagent_containers/hypospray/autoinjector/combat,
/turf/unsimulated/floor{
	icon = 'icons/turf/floors/smooth/hardfloor_3.dmi';
	icon_state = "center_8"
	},
/area/custom/arena)

(1,1,1) = {"
a
a
a
a
a
a
a
a
a
a
L
L
L
L
L
L
L
a
a
a
a
a
a
a
a
a
a
"}
(2,1,1) = {"
a
a
a
a
a
a
a
L
L
L
L
f
f
f
f
f
L
L
L
L
a
a
a
a
a
a
a
"}
(3,1,1) = {"
a
a
a
a
a
L
L
L
f
f
f
f
f
u
r
f
f
f
f
L
L
L
a
a
a
a
a
"}
(4,1,1) = {"
a
a
a
L
L
L
f
L
f
P
f
f
t
W
w
f
f
P
f
L
f
L
L
L
a
a
a
"}
(5,1,1) = {"
a
a
a
L
f
u
r
L
f
f
f
L
f
s
P
L
f
f
f
L
f
u
r
L
a
a
a
"}
(6,1,1) = {"
a
a
L
L
t
W
w
f
f
Z
f
L
L
L
L
L
f
Z
f
f
t
W
w
L
L
a
a
"}
(7,1,1) = {"
a
a
L
f
f
s
P
f
f
f
f
f
s
L
t
f
f
f
f
f
f
s
P
f
L
a
a
"}
(8,1,1) = {"
a
L
L
L
L
f
f
L
L
f
f
f
f
g
f
f
f
f
L
L
f
f
L
L
L
L
a
"}
(9,1,1) = {"
a
L
f
f
f
f
f
L
f
u
r
f
f
f
f
f
f
u
r
L
f
f
f
f
f
L
a
"}
(10,1,1) = {"
a
L
f
P
f
Z
f
f
t
W
w
L
f
P
f
L
t
W
w
f
f
Z
f
P
f
L
a
"}
(11,1,1) = {"
L
L
f
f
f
f
f
f
f
s
P
L
f
f
f
L
f
s
P
f
f
f
f
f
f
L
L
"}
(12,1,1) = {"
L
f
f
f
L
L
f
f
f
L
L
L
f
Z
f
L
L
L
f
f
f
L
L
f
f
f
L
"}
(13,1,1) = {"
L
f
f
u
r
L
t
f
f
f
f
f
f
f
f
f
f
f
f
f
s
L
f
u
r
f
L
"}
(14,1,1) = {"
L
f
t
W
w
L
L
g
f
P
f
Z
f
V
f
Z
f
P
f
g
L
L
t
W
w
f
L
"}
(15,1,1) = {"
L
f
f
s
P
L
s
f
f
f
f
f
f
f
f
f
f
f
f
f
t
L
f
s
P
f
L
"}
(16,1,1) = {"
L
f
f
f
L
L
f
f
f
L
L
L
f
Z
f
L
L
L
f
f
f
L
L
f
f
f
L
"}
(17,1,1) = {"
L
L
f
f
f
f
f
f
f
u
r
L
f
f
f
L
f
u
r
f
f
f
f
f
f
L
L
"}
(18,1,1) = {"
a
L
f
P
f
Z
f
f
t
W
w
L
f
P
f
L
t
W
w
f
f
Z
f
P
f
L
a
"}
(19,1,1) = {"
a
L
f
f
f
f
f
L
f
s
P
f
f
f
f
f
f
s
P
L
f
f
f
f
f
L
a
"}
(20,1,1) = {"
a
L
L
L
L
f
f
L
L
f
f
f
f
g
f
f
f
f
L
L
f
f
L
L
L
L
a
"}
(21,1,1) = {"
a
a
L
f
f
u
r
f
f
f
f
f
t
L
s
f
f
f
f
f
f
u
r
f
L
a
a
"}
(22,1,1) = {"
a
a
L
L
t
W
w
f
f
Z
f
L
L
L
L
L
f
Z
f
f
t
W
w
L
L
a
a
"}
(23,1,1) = {"
a
a
a
L
f
s
P
L
f
f
f
L
f
u
r
L
f
f
f
L
f
s
P
L
a
a
a
"}
(24,1,1) = {"
a
a
a
L
L
L
f
L
f
P
f
f
t
W
w
f
f
P
f
L
f
L
L
L
a
a
a
"}
(25,1,1) = {"
a
a
a
a
a
L
L
L
f
f
f
f
f
s
P
f
f
f
f
L
L
L
a
a
a
a
a
"}
(26,1,1) = {"
a
a
a
a
a
a
a
L
L
L
L
f
f
f
f
f
L
L
L
L
a
a
a
a
a
a
a
"}
(27,1,1) = {"
a
a
a
a
a
a
a
a
a
a
L
L
L
L
L
L
L
a
a
a
a
a
a
a
a
a
a
"}
