//MAP CONVERTED BY dmm2tgm.py THIS HEADER COMMENT PREVENTS RECONVERSION, DO NOT REMOVE
"a" = (
/turf/environment/space,
/area/space)
"f" = (
/turf/unsimulated/floor{
	icon = 'icons/turf/floors/smooth/hardfloor_3.dmi';
	icon_state = "center_8"
	},
/area/custom/arena)
"g" = (
/obj/item/weapon/gun/projectile/revolver/rocketlauncher/commando,
/turf/unsimulated/floor{
	icon = 'icons/turf/floors/smooth/hardfloor_3.dmi';
	icon_state = "center_8"
	},
/area/custom/arena)
"r" = (
/obj/effect/landmark/post_round_dm/gladiator{
	name = "Gladiator"
	},
/turf/unsimulated/floor{
	icon = 'icons/turf/floors/smooth/hardfloor_3.dmi';
	icon_state = "center_8"
	},
/area/custom/arena)
"s" = (
/obj/random/guns/energy_weapon,
/turf/unsimulated/floor{
	icon = 'icons/turf/floors/smooth/hardfloor_3.dmi';
	icon_state = "center_8"
	},
/area/custom/arena)
"t" = (
/obj/random/melee,
/turf/unsimulated/floor{
	icon = 'icons/turf/floors/smooth/hardfloor_3.dmi';
	icon_state = "center_8"
	},
/area/custom/arena)
"u" = (
/obj/random/cloth/helmet,
/turf/unsimulated/floor{
	icon = 'icons/turf/floors/smooth/hardfloor_3.dmi';
	icon_state = "center_8"
	},
/area/custom/arena)
"w" = (
/obj/random/cloth/armor,
/turf/unsimulated/floor{
	icon = 'icons/turf/floors/smooth/hardfloor_3.dmi';
	icon_state = "center_8"
	},
/area/custom/arena)
"L" = (
/turf/unsimulated/wall/like_a_normal/red,
/area/custom/arena)
"P" = (
/obj/item/weapon/reagent_containers/hypospray/autoinjector/combat,
/turf/unsimulated/floor{
	icon = 'icons/turf/floors/smooth/hardfloor_3.dmi';
	icon_state = "center_8"
	},
/area/custom/arena)
"V" = (
/obj/item/weapon/grenade/syndieminibomb,
/turf/unsimulated/floor{
	icon = 'icons/turf/floors/smooth/hardfloor_3.dmi';
	icon_state = "center_8"
	},
/area/custom/arena)
"W" = (
/obj/random/guns/projectile_handgun,
/turf/unsimulated/floor{
	icon = 'icons/turf/floors/smooth/hardfloor_3.dmi';
	icon_state = "center_8"
	},
/area/custom/arena)
"Z" = (
/obj/random/guns/set_special,
/turf/unsimulated/floor{
	icon = 'icons/turf/floors/smooth/hardfloor_3.dmi';
	icon_state = "center_8"
	},
/area/custom/arena)

(1,1,1) = {"
a
a
a
a
a
a
a
a
a
a
a
a
a
a
a
a
a
a
a
a
a
a
a
a
a
a
a
a
a
a
a
a
a
a
a
a
a
a
a
a
a
a
a
a
a
"}
(2,1,1) = {"
a
a
a
a
a
a
a
a
a
a
a
a
a
a
a
a
a
a
a
a
a
a
a
a
a
a
a
a
a
a
a
a
a
a
a
a
a
a
a
a
a
a
a
a
a
"}
(3,1,1) = {"
a
a
a
a
a
a
a
a
a
a
a
a
a
a
a
a
a
a
a
a
a
a
a
a
a
a
a
a
a
a
a
a
a
a
a
a
a
a
a
a
a
a
a
a
a
"}
(4,1,1) = {"
a
a
a
a
a
a
a
a
a
a
a
a
a
a
a
a
a
a
a
a
a
a
a
a
a
a
a
a
a
a
a
a
a
a
a
a
a
a
a
a
a
a
a
a
a
"}
(5,1,1) = {"
a
a
a
a
a
a
a
a
a
a
a
a
a
a
a
a
a
a
a
a
a
a
a
a
a
a
a
a
a
a
a
a
a
a
a
a
a
a
a
a
a
a
a
a
a
"}
(6,1,1) = {"
a
a
a
a
a
a
a
a
a
a
a
a
a
a
a
a
a
a
a
a
a
a
a
a
a
a
a
a
a
a
a
a
a
a
a
a
a
a
a
a
a
a
a
a
a
"}
(7,1,1) = {"
a
a
a
a
a
a
a
a
a
a
a
a
a
a
a
a
a
a
a
a
a
a
a
a
a
a
a
a
a
a
a
a
a
a
a
a
a
a
a
a
a
a
a
a
a
"}
(8,1,1) = {"
a
a
a
a
a
a
a
a
a
a
a
a
a
a
a
a
a
a
a
a
a
a
a
a
a
a
a
a
a
a
a
a
a
a
a
a
a
a
a
a
a
a
a
a
a
"}
(9,1,1) = {"
a
a
a
a
a
a
a
a
a
a
a
a
a
a
a
a
a
a
a
a
a
a
a
a
a
a
a
a
a
a
a
a
a
a
a
a
a
a
a
a
a
a
a
a
a
"}
(10,1,1) = {"
a
a
a
a
a
a
a
a
a
a
a
a
a
a
a
a
a
a
a
L
L
L
L
L
L
L
a
a
a
a
a
a
a
a
a
a
a
a
a
a
a
a
a
a
a
"}
(11,1,1) = {"
a
a
a
a
a
a
a
a
a
a
a
a
a
a
a
a
L
L
L
L
f
f
f
f
f
L
L
L
L
a
a
a
a
a
a
a
a
a
a
a
a
a
a
a
a
"}
(12,1,1) = {"
a
a
a
a
a
a
a
a
a
a
a
a
a
a
L
L
L
f
f
f
f
f
t
W
f
f
f
f
L
L
L
a
a
a
a
a
a
a
a
a
a
a
a
a
a
"}
(13,1,1) = {"
a
a
a
a
a
a
a
a
a
a
a
a
L
L
L
f
L
f
Z
f
f
u
r
s
f
f
Z
f
L
f
L
L
L
a
a
a
a
a
a
a
a
a
a
a
a
"}
(14,1,1) = {"
a
a
a
a
a
a
a
a
a
a
a
a
L
f
t
W
L
f
f
f
L
f
w
Z
L
f
f
f
L
f
t
W
L
a
a
a
a
a
a
a
a
a
a
a
a
"}
(15,1,1) = {"
a
a
a
a
a
a
a
a
a
a
a
L
L
u
r
s
f
f
P
f
L
L
L
L
L
f
P
f
f
u
r
s
L
L
a
a
a
a
a
a
a
a
a
a
a
"}
(16,1,1) = {"
a
a
a
a
a
a
a
a
a
a
a
L
f
f
w
Z
f
f
f
f
f
w
L
u
f
f
f
f
f
f
w
Z
f
L
a
a
a
a
a
a
a
a
a
a
a
"}
(17,1,1) = {"
a
a
a
a
a
a
a
a
a
a
L
L
L
L
f
f
L
L
f
f
f
f
V
f
f
f
f
L
L
f
f
L
L
L
L
a
a
a
a
a
a
a
a
a
a
"}
(18,1,1) = {"
a
a
a
a
a
a
a
a
a
a
L
f
f
f
f
f
L
f
t
W
f
f
f
f
f
f
t
W
L
f
f
f
f
f
L
a
a
a
a
a
a
a
a
a
a
"}
(19,1,1) = {"
a
a
a
a
a
a
a
a
a
a
L
f
Z
f
P
f
f
u
r
s
L
f
Z
f
L
u
r
s
f
f
P
f
Z
f
L
a
a
a
a
a
a
a
a
a
a
"}
(20,1,1) = {"
a
a
a
a
a
a
a
a
a
L
L
f
f
f
f
f
f
f
w
Z
L
f
f
f
L
f
w
Z
f
f
f
f
f
f
L
L
a
a
a
a
a
a
a
a
a
"}
(21,1,1) = {"
a
a
a
a
a
a
a
a
a
L
f
f
f
L
L
f
f
f
L
L
L
f
P
f
L
L
L
f
f
f
L
L
f
f
f
L
a
a
a
a
a
a
a
a
a
"}
(22,1,1) = {"
a
a
a
a
a
a
a
a
a
L
f
f
t
W
L
u
f
f
f
f
f
f
f
f
f
f
f
f
f
w
L
f
t
W
f
L
a
a
a
a
a
a
a
a
a
"}
(23,1,1) = {"
a
a
a
a
a
a
a
a
a
L
f
u
r
s
L
L
V
f
Z
f
P
f
g
f
P
f
Z
f
V
L
L
u
r
s
f
L
a
a
a
a
a
a
a
a
a
"}
(24,1,1) = {"
a
a
a
a
a
a
a
a
a
L
f
f
w
Z
L
w
f
f
f
f
f
f
f
f
f
f
f
f
f
u
L
f
w
Z
f
L
a
a
a
a
a
a
a
a
a
"}
(25,1,1) = {"
a
a
a
a
a
a
a
a
a
L
f
f
f
L
L
f
f
f
L
L
L
f
P
f
L
L
L
f
f
f
L
L
f
f
f
L
a
a
a
a
a
a
a
a
a
"}
(26,1,1) = {"
a
a
a
a
a
a
a
a
a
L
L
f
f
f
f
f
f
f
t
W
L
f
f
f
L
f
t
W
f
f
f
f
f
f
L
L
a
a
a
a
a
a
a
a
a
"}
(27,1,1) = {"
a
a
a
a
a
a
a
a
a
a
L
f
Z
f
P
f
f
u
r
s
L
f
Z
f
L
u
r
s
f
f
P
f
Z
f
L
a
a
a
a
a
a
a
a
a
a
"}
(28,1,1) = {"
a
a
a
a
a
a
a
a
a
a
L
f
f
f
f
f
L
f
w
Z
f
f
f
f
f
f
w
Z
L
f
f
f
f
f
L
a
a
a
a
a
a
a
a
a
a
"}
(29,1,1) = {"
a
a
a
a
a
a
a
a
a
a
L
L
L
L
f
f
L
L
f
f
f
f
V
f
f
f
f
L
L
f
f
L
L
L
L
a
a
a
a
a
a
a
a
a
a
"}
(30,1,1) = {"
a
a
a
a
a
a
a
a
a
a
a
L
f
f
t
W
f
f
f
f
f
u
L
w
f
f
f
f
f
f
t
W
f
L
a
a
a
a
a
a
a
a
a
a
a
"}
(31,1,1) = {"
a
a
a
a
a
a
a
a
a
a
a
L
L
u
r
s
f
f
P
f
L
L
L
L
L
f
P
f
f
u
r
s
L
L
a
a
a
a
a
a
a
a
a
a
a
"}
(32,1,1) = {"
a
a
a
a
a
a
a
a
a
a
a
a
L
f
w
Z
L
f
f
f
L
f
t
W
L
f
f
f
L
f
w
Z
L
a
a
a
a
a
a
a
a
a
a
a
a
"}
(33,1,1) = {"
a
a
a
a
a
a
a
a
a
a
a
a
L
L
L
f
L
f
Z
f
f
u
r
s
f
f
Z
f
L
f
L
L
L
a
a
a
a
a
a
a
a
a
a
a
a
"}
(34,1,1) = {"
a
a
a
a
a
a
a
a
a
a
a
a
a
a
L
L
L
f
f
f
f
f
w
Z
f
f
f
f
L
L
L
a
a
a
a
a
a
a
a
a
a
a
a
a
a
"}
(35,1,1) = {"
a
a
a
a
a
a
a
a
a
a
a
a
a
a
a
a
L
L
L
L
f
f
f
f
f
L
L
L
L
a
a
a
a
a
a
a
a
a
a
a
a
a
a
a
a
"}
(36,1,1) = {"
a
a
a
a
a
a
a
a
a
a
a
a
a
a
a
a
a
a
a
L
L
L
L
L
L
L
a
a
a
a
a
a
a
a
a
a
a
a
a
a
a
a
a
a
a
"}
(37,1,1) = {"
a
a
a
a
a
a
a
a
a
a
a
a
a
a
a
a
a
a
a
a
a
a
a
a
a
a
a
a
a
a
a
a
a
a
a
a
a
a
a
a
a
a
a
a
a
"}
(38,1,1) = {"
a
a
a
a
a
a
a
a
a
a
a
a
a
a
a
a
a
a
a
a
a
a
a
a
a
a
a
a
a
a
a
a
a
a
a
a
a
a
a
a
a
a
a
a
a
"}
(39,1,1) = {"
a
a
a
a
a
a
a
a
a
a
a
a
a
a
a
a
a
a
a
a
a
a
a
a
a
a
a
a
a
a
a
a
a
a
a
a
a
a
a
a
a
a
a
a
a
"}
(40,1,1) = {"
a
a
a
a
a
a
a
a
a
a
a
a
a
a
a
a
a
a
a
a
a
a
a
a
a
a
a
a
a
a
a
a
a
a
a
a
a
a
a
a
a
a
a
a
a
"}
(41,1,1) = {"
a
a
a
a
a
a
a
a
a
a
a
a
a
a
a
a
a
a
a
a
a
a
a
a
a
a
a
a
a
a
a
a
a
a
a
a
a
a
a
a
a
a
a
a
a
"}
(42,1,1) = {"
a
a
a
a
a
a
a
a
a
a
a
a
a
a
a
a
a
a
a
a
a
a
a
a
a
a
a
a
a
a
a
a
a
a
a
a
a
a
a
a
a
a
a
a
a
"}
(43,1,1) = {"
a
a
a
a
a
a
a
a
a
a
a
a
a
a
a
a
a
a
a
a
a
a
a
a
a
a
a
a
a
a
a
a
a
a
a
a
a
a
a
a
a
a
a
a
a
"}
(44,1,1) = {"
a
a
a
a
a
a
a
a
a
a
a
a
a
a
a
a
a
a
a
a
a
a
a
a
a
a
a
a
a
a
a
a
a
a
a
a
a
a
a
a
a
a
a
a
a
"}
(45,1,1) = {"
a
a
a
a
a
a
a
a
a
a
a
a
a
a
a
a
a
a
a
a
a
a
a
a
a
a
a
a
a
a
a
a
a
a
a
a
a
a
a
a
a
a
a
a
a
"}
