//MAP CONVERTED BY dmm2tgm.py THIS HEADER COMMENT PREVENTS RECONVERSION, DO NOT REMOVE
"a" = (
/turf/environment/space,
/area/space)
"i" = (
/obj/random/guns/energy_weapon,
/turf/unsimulated/floor/fakealien/weednode,
/area/custom/arena)
"l" = (
/obj/random/guns/set_special,
/turf/unsimulated/floor/fakealien/weednode,
/area/custom/arena)
"n" = (
/obj/effect/landmark/post_round_dm/gladiator{
	name = "Gladiator"
	},
/turf/unsimulated/floor/fakealien/weednode,
/area/custom/arena)
"p" = (
/obj/random/cloth/armor,
/turf/unsimulated/floor/fakealien,
/area/custom/arena)
"q" = (
/turf/unsimulated/wall/fakealien,
/area/custom/arena)
"r" = (
/obj/item/weapon/reagent_containers/hypospray/autoinjector/combat,
/turf/unsimulated/floor/fakealien,
/area/custom/arena)
"s" = (
/obj/structure/alien{
	desc = "It looks like a weird egg";
	icon_state = "egg";
	name = "egg"
	},
/turf/unsimulated/floor/fakealien,
/area/custom/arena)
"v" = (
/turf/unsimulated/floor/fakealien,
/area/custom/arena)
"x" = (
/obj/random/cloth/helmet,
/turf/unsimulated/floor/fakealien,
/area/custom/arena)
"y" = (
/obj/structure/barricade/wooden,
/obj/structure/barricade/wooden,
/turf/unsimulated/floor/fakealien,
/area/custom/arena)
"A" = (
/turf/unsimulated/wall/fakealienmembrane,
/area/custom/arena)
"C" = (
/obj/effect/landmark/post_round_dm/gladiator{
	name = "Gladiator"
	},
/turf/unsimulated/floor/fakealien,
/area/custom/arena)
"G" = (
/turf/unsimulated/floor/fakealien/weednode,
/area/custom/arena)
"H" = (
/obj/random/guns/projectile_handgun,
/turf/unsimulated/floor/fakealien/weednode,
/area/custom/arena)
"J" = (
/obj/random/guns/projectile_handgun,
/turf/unsimulated/floor/fakealien,
/area/custom/arena)
"K" = (
/obj/item/weapon/grenade/syndieminibomb,
/turf/unsimulated/floor/fakealien,
/area/custom/arena)
"L" = (
/obj/random/guns/set_special,
/turf/unsimulated/floor/fakealien,
/area/custom/arena)
"O" = (
/obj/random/melee,
/turf/unsimulated/floor/fakealien,
/area/custom/arena)
"R" = (
/obj/random/cloth/armor,
/turf/unsimulated/floor/fakealien/weednode,
/area/custom/arena)
"S" = (
/obj/mecha/combat/marauder/loaded{
	operation_req_access = list()
	},
/turf/unsimulated/floor/fakealien,
/area/custom/arena)
"U" = (
/obj/random/guns/energy_weapon,
/turf/unsimulated/floor/fakealien,
/area/custom/arena)
"V" = (
/obj/mecha/combat/marauder/mauler{
	operation_req_access = list()
	},
/turf/unsimulated/floor/fakealien,
/area/custom/arena)
"X" = (
/obj/random/cloth/helmet,
/turf/unsimulated/floor/fakealien/weednode,
/area/custom/arena)
"Z" = (
/obj/structure/alien/air_plant,
/turf/unsimulated/floor/fakealien,
/area/custom/arena)

(1,1,1) = {"
a
a
a
a
a
a
a
a
a
a
a
a
a
a
a
a
a
a
a
a
a
a
a
a
a
a
a
a
a
a
a
a
a
a
a
a
a
a
a
a
a
a
a
a
a
"}
(2,1,1) = {"
a
a
a
a
a
a
a
a
a
a
a
a
a
a
a
a
a
a
a
a
a
a
a
a
a
a
a
a
a
a
a
a
a
a
a
a
a
a
a
a
a
a
a
a
a
"}
(3,1,1) = {"
a
a
a
a
a
a
a
a
a
a
a
a
a
a
a
a
a
a
a
a
a
a
a
a
a
a
a
a
a
a
a
a
a
a
a
a
a
a
a
a
a
a
a
a
a
"}
(4,1,1) = {"
a
a
a
a
a
a
a
a
a
a
a
a
a
a
a
a
a
a
a
a
a
a
a
a
a
a
a
a
a
a
a
a
a
a
a
a
a
a
a
a
a
a
a
a
a
"}
(5,1,1) = {"
a
a
a
a
a
a
a
a
a
a
a
a
a
a
a
a
a
a
a
a
a
a
a
a
a
a
a
a
a
a
a
a
a
a
a
a
a
a
a
a
a
a
a
a
a
"}
(6,1,1) = {"
a
a
a
a
a
a
a
a
a
a
a
a
a
a
a
a
a
a
a
a
a
a
a
a
a
a
a
a
a
a
a
a
a
a
a
a
a
a
a
a
a
a
a
a
a
"}
(7,1,1) = {"
a
a
a
a
a
a
a
a
a
a
a
a
a
a
a
a
a
a
a
a
a
a
a
a
a
a
a
a
a
a
a
a
a
a
a
a
a
a
a
a
a
a
a
a
a
"}
(8,1,1) = {"
a
a
a
a
a
a
a
a
a
a
a
a
a
a
a
a
a
a
a
a
a
a
a
a
a
a
a
a
a
a
a
a
a
a
a
a
a
a
a
a
a
a
a
a
a
"}
(9,1,1) = {"
a
a
a
a
a
a
a
a
a
a
a
a
a
a
a
a
a
a
a
a
a
a
a
a
a
a
a
a
a
a
a
a
a
a
a
a
a
a
a
a
a
a
a
a
a
"}
(10,1,1) = {"
a
a
a
a
a
a
a
a
a
a
a
a
a
a
a
a
a
a
a
a
a
a
a
a
a
a
a
a
a
a
a
a
a
a
a
a
a
a
a
a
a
a
a
a
a
"}
(11,1,1) = {"
a
a
a
a
a
a
a
a
a
a
q
q
q
q
q
q
q
a
a
q
q
q
q
q
q
q
a
a
q
q
q
q
q
q
q
a
a
a
a
a
a
a
a
a
a
"}
(12,1,1) = {"
a
a
a
a
a
a
a
a
a
a
q
p
v
J
G
v
q
q
q
q
v
p
C
U
s
q
q
q
q
K
v
x
v
J
q
a
a
a
a
a
a
a
a
a
a
"}
(13,1,1) = {"
a
a
a
a
a
a
a
a
a
a
q
G
n
v
Z
v
v
G
l
v
v
J
v
x
v
q
p
v
A
G
Z
v
n
v
q
a
a
a
a
a
a
a
a
a
a
"}
(14,1,1) = {"
a
a
a
a
a
a
a
a
a
a
q
i
x
q
A
q
v
v
G
G
G
q
q
A
v
q
U
C
q
v
v
U
G
R
q
a
a
a
a
a
a
a
a
a
a
"}
(15,1,1) = {"
a
a
a
a
a
a
a
a
a
a
q
G
v
q
J
v
x
v
q
v
R
v
q
v
v
G
H
X
v
L
q
q
v
v
q
a
a
a
a
a
a
a
a
a
a
"}
(16,1,1) = {"
a
a
a
a
a
a
a
a
a
a
q
v
v
v
v
C
v
s
q
q
C
U
v
v
L
G
v
v
q
p
v
J
v
v
q
a
a
a
a
a
a
a
a
a
a
"}
(17,1,1) = {"
a
a
a
a
a
a
a
a
a
a
q
q
q
v
v
p
U
v
A
v
x
J
q
q
q
v
q
q
q
v
C
v
q
q
q
a
a
a
a
a
a
a
a
a
a
"}
(18,1,1) = {"
a
a
a
a
a
a
a
a
a
a
a
q
v
L
q
v
q
q
q
v
v
v
v
A
v
x
v
v
q
q
U
X
v
q
a
a
a
a
a
a
a
a
a
a
a
"}
(19,1,1) = {"
a
a
a
a
a
a
a
a
a
a
a
q
K
v
A
G
v
G
q
q
v
v
r
q
v
C
U
v
L
v
v
G
G
q
a
a
a
a
a
a
a
a
a
a
a
"}
(20,1,1) = {"
a
a
a
a
a
a
a
a
a
a
q
q
v
q
q
G
G
J
G
G
L
q
Z
v
J
G
R
v
v
q
q
q
v
q
q
a
a
a
a
a
a
a
a
a
a
"}
(21,1,1) = {"
a
a
a
a
a
a
a
a
a
a
q
s
v
v
q
v
R
n
X
v
q
q
q
q
A
q
q
G
A
q
v
U
v
s
q
a
a
a
a
a
a
a
a
a
a
"}
(22,1,1) = {"
a
a
a
a
a
a
a
a
a
a
q
x
G
i
q
v
G
i
v
v
O
q
S
q
O
p
v
J
v
q
x
C
p
v
q
a
a
a
a
a
a
a
a
a
a
"}
(23,1,1) = {"
a
a
a
a
a
a
a
a
a
a
q
v
n
v
v
v
v
q
q
Z
v
y
r
y
v
v
C
v
v
q
v
H
v
q
q
a
a
a
a
a
a
a
a
a
a
"}
(24,1,1) = {"
a
a
a
a
a
a
a
a
a
a
q
J
G
p
q
q
A
q
v
G
O
q
V
q
O
v
U
x
v
L
v
G
G
v
q
a
a
a
a
a
a
a
a
a
a
"}
(25,1,1) = {"
a
a
a
a
a
a
a
a
a
a
q
v
v
v
v
q
s
p
U
G
q
q
q
q
q
v
q
q
A
q
v
v
l
Z
q
a
a
a
a
a
a
a
a
a
a
"}
(26,1,1) = {"
a
a
a
a
a
a
a
a
a
a
q
q
q
q
v
v
L
v
n
X
v
q
v
r
v
l
v
v
v
q
A
q
v
q
q
a
a
a
a
a
a
a
a
a
a
"}
(27,1,1) = {"
a
a
a
a
a
a
a
a
a
a
a
q
v
J
G
p
q
v
v
H
v
L
G
A
v
G
X
i
v
v
v
J
x
q
a
a
a
a
a
a
a
a
a
a
a
"}
(28,1,1) = {"
a
a
a
a
a
a
a
a
a
a
a
q
v
v
C
U
q
A
q
v
v
v
v
q
q
q
v
C
p
q
p
C
v
q
a
a
a
a
a
a
a
a
a
a
a
"}
(29,1,1) = {"
a
a
a
a
a
a
a
a
a
a
q
q
v
x
v
q
q
v
v
G
q
v
q
q
v
v
J
v
s
q
v
U
q
q
q
a
a
a
a
a
a
a
a
a
a
"}
(30,1,1) = {"
a
a
a
a
a
a
a
a
a
a
q
s
L
q
v
v
q
x
G
v
A
v
v
p
v
v
q
q
q
q
v
v
v
v
q
a
a
a
a
a
a
a
a
a
a
"}
(31,1,1) = {"
a
a
a
a
a
a
a
a
a
a
q
v
G
q
q
Z
v
n
i
q
q
q
G
G
n
U
v
q
K
v
v
q
q
G
q
a
a
a
a
a
a
a
a
a
a
"}
(32,1,1) = {"
a
a
a
a
a
a
a
a
a
a
q
v
R
v
q
v
J
G
p
v
v
L
G
J
x
Z
v
A
v
G
v
U
v
G
q
a
a
a
a
a
a
a
a
a
a
"}
(33,1,1) = {"
a
a
a
a
a
a
a
a
a
a
q
U
n
G
v
L
q
v
v
q
v
v
v
A
v
G
v
L
v
v
x
n
R
v
q
a
a
a
a
a
a
a
a
a
a
"}
(34,1,1) = {"
a
a
a
a
a
a
a
a
a
a
q
J
v
X
G
v
q
q
q
q
K
v
s
q
v
q
q
q
q
v
v
H
v
s
q
a
a
a
a
a
a
a
a
a
a
"}
(35,1,1) = {"
a
a
a
a
a
a
a
a
a
a
q
q
q
q
q
q
q
a
a
q
q
q
q
q
q
q
a
a
q
q
q
q
q
q
q
a
a
a
a
a
a
a
a
a
a
"}
(36,1,1) = {"
a
a
a
a
a
a
a
a
a
a
a
a
a
a
a
a
a
a
a
a
a
a
a
a
a
a
a
a
a
a
a
a
a
a
a
a
a
a
a
a
a
a
a
a
a
"}
(37,1,1) = {"
a
a
a
a
a
a
a
a
a
a
a
a
a
a
a
a
a
a
a
a
a
a
a
a
a
a
a
a
a
a
a
a
a
a
a
a
a
a
a
a
a
a
a
a
a
"}
(38,1,1) = {"
a
a
a
a
a
a
a
a
a
a
a
a
a
a
a
a
a
a
a
a
a
a
a
a
a
a
a
a
a
a
a
a
a
a
a
a
a
a
a
a
a
a
a
a
a
"}
(39,1,1) = {"
a
a
a
a
a
a
a
a
a
a
a
a
a
a
a
a
a
a
a
a
a
a
a
a
a
a
a
a
a
a
a
a
a
a
a
a
a
a
a
a
a
a
a
a
a
"}
(40,1,1) = {"
a
a
a
a
a
a
a
a
a
a
a
a
a
a
a
a
a
a
a
a
a
a
a
a
a
a
a
a
a
a
a
a
a
a
a
a
a
a
a
a
a
a
a
a
a
"}
(41,1,1) = {"
a
a
a
a
a
a
a
a
a
a
a
a
a
a
a
a
a
a
a
a
a
a
a
a
a
a
a
a
a
a
a
a
a
a
a
a
a
a
a
a
a
a
a
a
a
"}
(42,1,1) = {"
a
a
a
a
a
a
a
a
a
a
a
a
a
a
a
a
a
a
a
a
a
a
a
a
a
a
a
a
a
a
a
a
a
a
a
a
a
a
a
a
a
a
a
a
a
"}
(43,1,1) = {"
a
a
a
a
a
a
a
a
a
a
a
a
a
a
a
a
a
a
a
a
a
a
a
a
a
a
a
a
a
a
a
a
a
a
a
a
a
a
a
a
a
a
a
a
a
"}
(44,1,1) = {"
a
a
a
a
a
a
a
a
a
a
a
a
a
a
a
a
a
a
a
a
a
a
a
a
a
a
a
a
a
a
a
a
a
a
a
a
a
a
a
a
a
a
a
a
a
"}
(45,1,1) = {"
a
a
a
a
a
a
a
a
a
a
a
a
a
a
a
a
a
a
a
a
a
a
a
a
a
a
a
a
a
a
a
a
a
a
a
a
a
a
a
a
a
a
a
a
a
"}
