//MAP CONVERTED BY dmm2tgm.py THIS HEADER COMMENT PREVENTS RECONVERSION, DO NOT REMOVE
"a" = (
/turf/environment/space,
/area/space)
"b" = (
/obj/random/guns/set_special,
/turf/unsimulated/floor/fakealien/weednode,
/area/custom/arena)
"e" = (
/obj/mecha/combat/marauder/mauler{
	operation_req_access = list()
	},
/turf/unsimulated/floor/fakealien,
/area/custom/arena)
"i" = (
/obj/random/guns/projectile_handgun,
/turf/unsimulated/floor/fakealien,
/area/custom/arena)
"k" = (
/obj/effect/landmark/post_round_dm/gladiator{
	name = "Gladiator"
	},
/turf/unsimulated/floor/fakealien,
/area/custom/arena)
"l" = (
/obj/item/weapon/grenade/syndieminibomb,
/turf/unsimulated/floor/fakealien,
/area/custom/arena)
"n" = (
/obj/item/weapon/reagent_containers/hypospray/autoinjector/combat,
/turf/unsimulated/floor/fakealien,
/area/custom/arena)
"o" = (
/obj/random/melee,
/turf/unsimulated/floor/fakealien,
/area/custom/arena)
"p" = (
/obj/random/cloth/helmet,
/turf/unsimulated/floor/fakealien,
/area/custom/arena)
"q" = (
/turf/unsimulated/wall/fakealien,
/area/custom/arena)
"v" = (
/turf/unsimulated/floor/fakealien,
/area/custom/arena)
"y" = (
/obj/random/guns/energy_weapon,
/turf/unsimulated/floor/fakealien,
/area/custom/arena)
"z" = (
/obj/structure/barricade/wooden,
/obj/structure/barricade/wooden,
/turf/unsimulated/floor/fakealien,
/area/custom/arena)
"G" = (
/obj/effect/landmark/post_round_dm/gladiator{
	name = "Gladiator"
	},
/turf/unsimulated/floor/fakealien/weednode,
/area/custom/arena)
"H" = (
/obj/structure/alien{
	desc = "It looks like a weird egg";
	icon_state = "egg";
	name = "egg"
	},
/turf/unsimulated/floor/fakealien,
/area/custom/arena)
"K" = (
/obj/random/cloth/helmet,
/turf/unsimulated/floor/fakealien/weednode,
/area/custom/arena)
"O" = (
/turf/unsimulated/floor/fakealien/weednode,
/area/custom/arena)
"R" = (
/obj/structure/alien/air_plant,
/turf/unsimulated/floor/fakealien,
/area/custom/arena)
"S" = (
/obj/random/cloth/armor,
/turf/unsimulated/floor/fakealien/weednode,
/area/custom/arena)
"T" = (
/obj/random/guns/projectile_handgun,
/turf/unsimulated/floor/fakealien/weednode,
/area/custom/arena)
"U" = (
/obj/random/guns/energy_weapon,
/turf/unsimulated/floor/fakealien/weednode,
/area/custom/arena)
"V" = (
/turf/unsimulated/wall/fakealienmembrane,
/area/custom/arena)
"W" = (
/obj/mecha/combat/marauder/loaded{
	operation_req_access = list()
	},
/turf/unsimulated/floor/fakealien,
/area/custom/arena)
"X" = (
/obj/random/cloth/armor,
/turf/unsimulated/floor/fakealien,
/area/custom/arena)
"Z" = (
/obj/random/guns/set_special,
/turf/unsimulated/floor/fakealien,
/area/custom/arena)

(1,1,1) = {"
q
q
q
q
q
q
q
a
a
q
q
q
q
q
q
q
a
a
q
q
q
q
q
q
q
"}
(2,1,1) = {"
q
X
v
i
O
v
q
q
q
q
v
X
k
y
H
q
q
q
q
l
v
p
v
i
q
"}
(3,1,1) = {"
q
O
G
v
R
v
v
O
b
v
v
i
v
p
v
q
X
v
V
O
R
v
G
v
q
"}
(4,1,1) = {"
q
U
p
q
V
q
v
v
O
O
O
q
q
V
v
q
y
k
q
v
v
y
O
S
q
"}
(5,1,1) = {"
q
O
v
q
i
v
p
v
q
v
S
v
q
v
v
O
T
K
v
Z
q
q
v
v
q
"}
(6,1,1) = {"
q
v
v
v
v
k
v
H
q
q
k
y
v
v
Z
O
v
v
q
X
v
i
v
v
q
"}
(7,1,1) = {"
q
q
q
v
v
X
y
v
V
v
p
i
q
q
q
v
q
q
q
v
k
v
q
q
q
"}
(8,1,1) = {"
a
q
v
Z
q
v
q
q
q
v
v
v
v
V
v
p
v
v
q
q
y
K
v
q
a
"}
(9,1,1) = {"
a
q
l
v
V
O
v
O
q
q
v
v
n
q
v
k
y
v
Z
v
v
O
O
q
a
"}
(10,1,1) = {"
q
q
v
q
q
O
O
i
O
O
Z
q
R
v
i
O
S
v
v
q
q
q
v
q
q
"}
(11,1,1) = {"
q
H
v
v
q
v
S
G
K
v
q
q
q
q
V
q
q
O
V
q
v
y
v
H
q
"}
(12,1,1) = {"
q
p
O
U
q
v
O
U
v
v
o
q
W
q
o
X
v
i
v
q
p
k
X
v
q
"}
(13,1,1) = {"
q
v
G
v
v
v
v
q
q
R
v
z
n
z
v
v
k
v
v
q
v
T
v
q
q
"}
(14,1,1) = {"
q
i
O
X
q
q
V
q
v
O
o
q
e
q
o
v
y
p
v
Z
v
O
O
v
q
"}
(15,1,1) = {"
q
v
v
v
v
q
H
X
y
O
q
q
q
q
q
v
q
q
V
q
v
v
b
R
q
"}
(16,1,1) = {"
q
q
q
q
v
v
Z
v
G
K
v
q
v
n
v
b
v
v
v
q
V
q
v
q
q
"}
(17,1,1) = {"
a
q
v
i
O
X
q
v
v
T
v
Z
O
V
v
O
K
U
v
v
v
i
p
q
a
"}
(18,1,1) = {"
a
q
v
v
k
y
q
V
q
v
v
v
v
q
q
q
v
k
X
q
X
k
v
q
a
"}
(19,1,1) = {"
q
q
v
p
v
q
q
v
v
O
q
v
q
q
v
v
i
v
H
q
v
y
q
q
q
"}
(20,1,1) = {"
q
H
Z
q
v
v
q
p
O
v
V
v
v
X
v
v
q
q
q
q
v
v
v
v
q
"}
(21,1,1) = {"
q
v
O
q
q
R
v
G
U
q
q
q
O
O
G
y
v
q
l
v
v
q
q
O
q
"}
(22,1,1) = {"
q
v
S
v
q
v
i
O
X
v
v
Z
O
i
p
R
v
V
v
O
v
y
v
O
q
"}
(23,1,1) = {"
q
y
G
O
v
Z
q
v
v
q
v
v
v
V
v
O
v
Z
v
v
p
G
S
v
q
"}
(24,1,1) = {"
q
i
v
K
O
v
q
q
q
q
l
v
H
q
v
q
q
q
q
v
v
T
v
H
q
"}
(25,1,1) = {"
q
q
q
q
q
q
q
a
a
q
q
q
q
q
q
q
a
a
q
q
q
q
q
q
q
"}
