//MAP CONVERTED BY dmm2tgm.py THIS HEADER COMMENT PREVENTS RECONVERSION, DO NOT REMOVE
"c" = (
/obj/random/guns/energy_weapon,
/turf/unsimulated/floor/cult/lava,
/area/custom/arena)
"d" = (
/obj/random/guns/set_special,
/turf/unsimulated/floor/cult/lava,
/area/custom/arena)
"f" = (
/turf/unsimulated/floor/cult/lava,
/area/custom/arena)
"m" = (
/obj/structure/cult/statue{
	icon_state = "gargoyle"
	},
/turf/unsimulated/floor/cult/lava,
/area/custom/arena)
"o" = (
/obj/effect/landmark/post_round_dm/gladiator{
	name = "Gladiator"
	},
/turf/unsimulated/floor/cult,
/area/custom/arena)
"p" = (
/obj/structure/pedestal/cult,
/turf/unsimulated/floor/cult/lava,
/area/custom/arena)
"z" = (
/obj/random/guns/projectile_handgun,
/turf/unsimulated/floor/cult/lava,
/area/custom/arena)
"B" = (
/turf/unsimulated/wall/cult/runed/anim,
/area/custom/arena)
"D" = (
/obj/structure/cult/statue,
/turf/unsimulated/floor/cult,
/area/custom/arena)
"E" = (
/obj/item/clothing/suit/armor/syndilight,
/turf/unsimulated/floor/cult/lava,
/area/custom/arena)
"G" = (
/obj/item/clothing/head/helmet/syndilight,
/turf/unsimulated/floor/cult/lava,
/area/custom/arena)
"O" = (
/obj/structure/cult/statue,
/turf/unsimulated/floor/cult/lava,
/area/custom/arena)
"U" = (
/turf/environment/space,
/area/space)
"V" = (
/obj/item/weapon/reagent_containers/hypospray/autoinjector/combat,
/turf/unsimulated/floor/cult/lava,
/area/custom/arena)
"Y" = (
/turf/unsimulated/floor/cult,
/area/custom/arena)
"Z" = (
/obj/structure/cult/statue{
	icon_state = "gargoyle"
	},
/turf/unsimulated/floor/cult,
/area/custom/arena)

(1,1,1) = {"
U
U
U
U
U
U
U
U
U
U
U
U
U
U
U
U
U
U
U
U
U
U
U
U
U
U
U
U
U
U
U
U
U
U
U
U
U
U
U
U
U
U
U
U
U
"}
(2,1,1) = {"
U
U
U
U
U
U
U
U
U
U
U
U
U
U
U
U
U
U
U
U
U
U
U
U
U
U
U
U
U
U
U
U
U
U
U
U
U
U
U
U
U
U
U
U
U
"}
(3,1,1) = {"
U
U
U
U
U
U
U
U
U
U
U
U
U
U
U
U
U
U
U
U
U
U
U
U
U
U
U
U
U
U
U
U
U
U
U
U
U
U
U
U
U
U
U
U
U
"}
(4,1,1) = {"
U
U
U
U
U
U
U
U
U
U
U
U
U
U
U
U
U
U
U
U
U
U
U
U
U
U
U
U
U
U
U
U
U
U
U
U
U
U
U
U
U
U
U
U
U
"}
(5,1,1) = {"
U
U
U
U
U
U
U
U
U
U
U
U
U
U
U
U
U
U
U
U
U
U
U
U
U
U
U
U
U
U
U
U
U
U
U
U
U
U
U
U
U
U
U
U
U
"}
(6,1,1) = {"
U
U
U
U
U
U
U
U
U
U
U
U
U
U
U
U
U
U
U
U
U
U
U
U
U
U
U
U
U
U
U
U
U
U
U
U
U
U
U
U
U
U
U
U
U
"}
(7,1,1) = {"
U
U
U
U
U
U
U
U
U
U
U
U
U
U
U
U
U
U
U
U
U
U
U
U
U
U
U
U
U
U
U
U
U
U
U
U
U
U
U
U
U
U
U
U
U
"}
(8,1,1) = {"
U
U
U
U
U
U
U
U
U
U
U
U
U
U
U
U
U
U
U
U
U
U
U
U
U
U
U
U
U
U
U
U
U
U
U
U
U
U
U
U
U
U
U
U
U
"}
(9,1,1) = {"
U
U
U
U
U
U
U
U
U
U
U
U
U
U
U
U
U
U
U
U
U
U
U
U
U
U
U
U
U
U
U
U
U
U
U
U
U
U
U
U
U
U
U
U
U
"}
(10,1,1) = {"
U
U
U
U
U
U
U
U
U
U
U
U
U
U
U
U
U
U
U
U
U
U
U
U
U
U
U
U
U
U
U
U
U
U
U
U
U
U
U
U
U
U
U
U
U
"}
(11,1,1) = {"
U
U
U
U
U
U
U
U
U
U
U
U
U
U
U
U
U
U
U
U
U
U
U
U
U
U
U
U
U
U
U
U
U
U
U
U
U
U
U
U
U
U
U
U
U
"}
(12,1,1) = {"
U
U
U
U
U
U
U
U
U
U
U
U
U
U
U
U
U
U
U
U
U
U
U
U
U
U
U
U
U
U
U
U
U
U
U
U
U
U
U
U
U
U
U
U
U
"}
(13,1,1) = {"
U
U
U
U
U
U
U
U
U
U
U
U
U
U
U
U
U
U
U
U
U
U
U
U
U
U
U
U
U
U
U
U
U
U
U
U
U
U
U
U
U
U
U
U
U
"}
(14,1,1) = {"
U
U
U
U
U
U
U
U
U
U
U
U
U
U
U
U
U
U
U
U
U
U
U
U
U
U
U
U
U
U
U
U
U
U
U
U
U
U
U
U
U
U
U
U
U
"}
(15,1,1) = {"
U
U
U
U
U
U
U
U
U
U
U
U
U
U
U
U
U
U
U
U
U
U
U
U
U
U
U
U
U
U
U
U
U
U
U
U
U
U
U
U
U
U
U
U
U
"}
(16,1,1) = {"
U
U
U
U
U
U
U
U
U
U
U
U
U
U
U
B
B
B
B
B
B
B
B
B
B
B
B
B
B
B
U
U
U
U
U
U
U
U
U
U
U
U
U
U
U
"}
(17,1,1) = {"
U
U
U
U
U
U
U
U
U
U
U
U
U
U
U
B
m
G
f
c
f
p
B
p
f
c
f
G
O
B
U
U
U
U
U
U
U
U
U
U
U
U
U
U
U
"}
(18,1,1) = {"
U
U
U
U
U
U
U
U
U
U
U
U
U
U
U
B
E
o
f
Y
Y
f
B
f
Y
Y
f
o
E
B
U
U
U
U
U
U
U
U
U
U
U
U
U
U
U
"}
(19,1,1) = {"
U
U
U
U
U
U
U
U
U
U
U
U
U
U
U
B
f
f
V
B
Y
d
f
d
Y
B
V
f
f
B
U
U
U
U
U
U
U
U
U
U
U
U
U
U
U
"}
(20,1,1) = {"
U
U
U
U
U
U
U
U
U
U
U
U
U
U
U
B
z
Y
B
B
Y
Y
f
Y
Y
B
B
Y
z
B
U
U
U
U
U
U
U
U
U
U
U
U
U
U
U
"}
(21,1,1) = {"
U
U
U
U
U
U
U
U
U
U
U
U
U
U
U
B
f
Y
Y
Y
f
f
d
f
f
Y
Y
Y
f
B
U
U
U
U
U
U
U
U
U
U
U
U
U
U
U
"}
(22,1,1) = {"
U
U
U
U
U
U
U
U
U
U
U
U
U
U
U
B
p
f
d
Y
f
Y
D
Y
f
Y
d
f
p
B
U
U
U
U
U
U
U
U
U
U
U
U
U
U
U
"}
(23,1,1) = {"
U
U
U
U
U
U
U
U
U
U
U
U
U
U
U
B
B
B
f
f
d
Z
B
Z
d
f
f
B
B
B
U
U
U
U
U
U
U
U
U
U
U
U
U
U
U
"}
(24,1,1) = {"
U
U
U
U
U
U
U
U
U
U
U
U
U
U
U
B
p
f
d
Y
f
Y
D
Y
f
Y
d
f
p
B
U
U
U
U
U
U
U
U
U
U
U
U
U
U
U
"}
(25,1,1) = {"
U
U
U
U
U
U
U
U
U
U
U
U
U
U
U
B
f
Y
Y
Y
f
f
d
f
f
Y
Y
Y
f
B
U
U
U
U
U
U
U
U
U
U
U
U
U
U
U
"}
(26,1,1) = {"
U
U
U
U
U
U
U
U
U
U
U
U
U
U
U
B
z
Y
B
B
Y
Y
f
Y
Y
B
B
Y
z
B
U
U
U
U
U
U
U
U
U
U
U
U
U
U
U
"}
(27,1,1) = {"
U
U
U
U
U
U
U
U
U
U
U
U
U
U
U
B
f
f
V
B
Y
d
f
d
Y
B
V
f
f
B
U
U
U
U
U
U
U
U
U
U
U
U
U
U
U
"}
(28,1,1) = {"
U
U
U
U
U
U
U
U
U
U
U
U
U
U
U
B
E
o
f
Y
Y
f
B
f
Y
Y
f
o
E
B
U
U
U
U
U
U
U
U
U
U
U
U
U
U
U
"}
(29,1,1) = {"
U
U
U
U
U
U
U
U
U
U
U
U
U
U
U
B
O
G
f
c
f
p
B
p
f
c
f
G
m
B
U
U
U
U
U
U
U
U
U
U
U
U
U
U
U
"}
(30,1,1) = {"
U
U
U
U
U
U
U
U
U
U
U
U
U
U
U
B
B
B
B
B
B
B
B
B
B
B
B
B
B
B
U
U
U
U
U
U
U
U
U
U
U
U
U
U
U
"}
(31,1,1) = {"
U
U
U
U
U
U
U
U
U
U
U
U
U
U
U
U
U
U
U
U
U
U
U
U
U
U
U
U
U
U
U
U
U
U
U
U
U
U
U
U
U
U
U
U
U
"}
(32,1,1) = {"
U
U
U
U
U
U
U
U
U
U
U
U
U
U
U
U
U
U
U
U
U
U
U
U
U
U
U
U
U
U
U
U
U
U
U
U
U
U
U
U
U
U
U
U
U
"}
(33,1,1) = {"
U
U
U
U
U
U
U
U
U
U
U
U
U
U
U
U
U
U
U
U
U
U
U
U
U
U
U
U
U
U
U
U
U
U
U
U
U
U
U
U
U
U
U
U
U
"}
(34,1,1) = {"
U
U
U
U
U
U
U
U
U
U
U
U
U
U
U
U
U
U
U
U
U
U
U
U
U
U
U
U
U
U
U
U
U
U
U
U
U
U
U
U
U
U
U
U
U
"}
(35,1,1) = {"
U
U
U
U
U
U
U
U
U
U
U
U
U
U
U
U
U
U
U
U
U
U
U
U
U
U
U
U
U
U
U
U
U
U
U
U
U
U
U
U
U
U
U
U
U
"}
(36,1,1) = {"
U
U
U
U
U
U
U
U
U
U
U
U
U
U
U
U
U
U
U
U
U
U
U
U
U
U
U
U
U
U
U
U
U
U
U
U
U
U
U
U
U
U
U
U
U
"}
(37,1,1) = {"
U
U
U
U
U
U
U
U
U
U
U
U
U
U
U
U
U
U
U
U
U
U
U
U
U
U
U
U
U
U
U
U
U
U
U
U
U
U
U
U
U
U
U
U
U
"}
(38,1,1) = {"
U
U
U
U
U
U
U
U
U
U
U
U
U
U
U
U
U
U
U
U
U
U
U
U
U
U
U
U
U
U
U
U
U
U
U
U
U
U
U
U
U
U
U
U
U
"}
(39,1,1) = {"
U
U
U
U
U
U
U
U
U
U
U
U
U
U
U
U
U
U
U
U
U
U
U
U
U
U
U
U
U
U
U
U
U
U
U
U
U
U
U
U
U
U
U
U
U
"}
(40,1,1) = {"
U
U
U
U
U
U
U
U
U
U
U
U
U
U
U
U
U
U
U
U
U
U
U
U
U
U
U
U
U
U
U
U
U
U
U
U
U
U
U
U
U
U
U
U
U
"}
(41,1,1) = {"
U
U
U
U
U
U
U
U
U
U
U
U
U
U
U
U
U
U
U
U
U
U
U
U
U
U
U
U
U
U
U
U
U
U
U
U
U
U
U
U
U
U
U
U
U
"}
(42,1,1) = {"
U
U
U
U
U
U
U
U
U
U
U
U
U
U
U
U
U
U
U
U
U
U
U
U
U
U
U
U
U
U
U
U
U
U
U
U
U
U
U
U
U
U
U
U
U
"}
(43,1,1) = {"
U
U
U
U
U
U
U
U
U
U
U
U
U
U
U
U
U
U
U
U
U
U
U
U
U
U
U
U
U
U
U
U
U
U
U
U
U
U
U
U
U
U
U
U
U
"}
(44,1,1) = {"
U
U
U
U
U
U
U
U
U
U
U
U
U
U
U
U
U
U
U
U
U
U
U
U
U
U
U
U
U
U
U
U
U
U
U
U
U
U
U
U
U
U
U
U
U
"}
(45,1,1) = {"
U
U
U
U
U
U
U
U
U
U
U
U
U
U
U
U
U
U
U
U
U
U
U
U
U
U
U
U
U
U
U
U
U
U
U
U
U
U
U
U
U
U
U
U
U
"}
